id,Date_From,Date_To,Days,Instock,Sellstock,profit,Lose
1,2000-01-02,2000-01-05,4,825608,817960,7648,0
2,2000-01-06,2000-01-08,3,2048886,1986441,62445,0
3,2000-01-09,2000-01-12,4,3173388,1540652,1632736,0
4,2000-01-13,2000-01-17,5,4443405,886060,3557345,0
5,2000-01-18,2000-01-22,5,861175,782245,78930,0
6,2000-01-23,2000-01-27,5,3430740,610365,2820375,0
7,2000-01-28,2000-01-30,3,2422560,1499706,922854,0
8,2000-01-31,2000-02-01,2,1282758,562020,720738,0
9,2000-02-02,2000-02-03,2,1496058,788344,707714,0
10,2000-02-04,2000-02-06,3,1176792,416181,760611,0
11,2000-02-07,2000-02-10,4,607860,526340,81520,0
12,2000-02-11,2000-02-14,4,2694276,1364536,1329740,0
13,2000-02-15,2000-02-19,5,3059540,2818255,241285,0
14,2000-02-20,2000-02-23,4,3367740,1231236,2136504,0
15,2000-02-24,2000-02-28,5,4399050,1261650,3137400,0
16,2000-02-29,2000-03-02,3,2702628,629949,2072679,0
17,2000-03-03,2000-03-06,4,2767992,1685964,1082028,0
18,2000-03-07,2000-03-09,3,2477355,325383,2151972,0
19,2000-03-10,2000-03-12,3,2982534,1598451,1384083,0
20,2000-03-13,2000-03-15,3,2366775,1883889,482886,0
21,2000-03-16,2000-03-19,4,2265700,907816,1357884,0
22,2000-03-20,2000-03-21,2,968878,475612,493266,0
23,2000-03-22,2000-03-23,2,1496388,368734,1127654,0
24,2000-03-24,2000-03-27,4,1013364,454432,558932,0
25,2000-03-28,2000-03-29,2,526622,363102,163520,0
26,2000-03-30,2000-03-31,2,817046,725566,91480,0
27,2000-04-01,2000-04-05,5,4224915,1580030,2644885,0
28,2000-04-06,2000-04-09,4,2239000,1109380,1129620,0
29,2000-04-10,2000-04-14,5,1303925,605175,698750,0
30,2000-04-15,2000-04-16,2,1477326,867742,609584,0
31,2000-04-17,2000-04-21,5,3188355,2165865,1022490,0
32,2000-04-22,2000-04-24,3,2171328,1120761,1050567,0
33,2000-04-25,2000-04-26,2,1173938,757916,416022,0
34,2000-04-27,2000-04-29,3,796443,748176,48267,0
35,2000-04-30,2000-05-02,3,2488149,902928,1585221,0
36,2000-05-03,2000-05-05,3,633132,476082,157050,0
37,2000-05-06,2000-05-08,3,2459967,1880361,579606,0
38,2000-05-09,2000-05-13,5,4648030,595445,4052585,0
39,2000-05-14,2000-05-16,3,2319726,2145726,174000,0
40,2000-05-17,2000-05-20,4,2948720,1513508,1435212,0
41,2000-05-21,2000-05-25,5,4939850,560020,4379830,0
42,2000-05-26,2000-05-30,5,3108290,1581745,1526545,0
43,2000-05-31,2000-06-04,5,1361875,1095405,266470,0
44,2000-06-05,2000-06-06,2,1735614,883078,852536,0
45,2000-06-07,2000-06-08,2,1338074,569506,768568,0
46,2000-06-09,2000-06-13,5,1911330,654105,1257225,0
47,2000-06-14,2000-06-17,4,1919628,799244,1120384,0
48,2000-06-18,2000-06-19,2,1037104,479272,557832,0
49,2000-06-20,2000-06-22,3,2373945,448038,1925907,0
50,2000-06-23,2000-06-25,3,2406162,1642962,763200,0
51,2000-06-26,2000-06-27,2,597924,512688,85236,0
52,2000-06-28,2000-07-02,5,4775195,2143905,2631290,0
53,2000-07-03,2000-07-05,3,2798787,699510,2099277,0
54,2000-07-06,2000-07-08,3,664938,311424,353514,0
55,2000-07-09,2000-07-10,2,1765332,1634300,131032,0
56,2000-07-11,2000-07-14,4,1171568,692256,479312,0
57,2000-07-15,2000-07-16,2,444006,443136,870,0
58,2000-07-17,2000-07-20,4,526672,504060,22612,0
59,2000-07-21,2000-07-22,2,468286,417434,50852,0
60,2000-07-23,2000-07-27,5,3488695,2286215,1202480,0
61,2000-07-28,2000-07-31,4,3746656,2030740,1715916,0
62,2000-08-01,2000-08-03,3,2018235,367641,1650594,0
63,2000-08-04,2000-08-08,5,2032590,690870,1341720,0
64,2000-08-09,2000-08-13,5,1426010,1261540,164470,0
65,2000-08-14,2000-08-16,3,1215105,335382,879723,0
66,2000-08-17,2000-08-20,4,2542004,863204,1678800,0
67,2000-08-21,2000-08-25,5,1514585,515015,999570,0
68,2000-08-26,2000-08-29,4,1283628,695332,588296,0
69,2000-08-30,2000-09-02,4,3620972,2193612,1427360,0
70,2000-09-03,2000-09-05,3,481686,369651,112035,0
71,2000-09-06,2000-09-07,2,352928,221024,131904,0
72,2000-09-08,2000-09-11,4,2881924,2669544,212380,0
73,2000-09-12,2000-09-14,3,1996236,1060065,936171,0
74,2000-09-15,2000-09-18,4,2954212,583800,2370412,0
75,2000-09-19,2000-09-20,2,1460572,1017902,442670,0
76,2000-09-21,2000-09-22,2,1899092,1634440,264652,0
77,2000-09-23,2000-09-24,2,327330,278770,48560,0
78,2000-09-25,2000-09-27,3,2130294,873420,1256874,0
79,2000-09-28,2000-09-30,3,1252515,495369,757146,0
80,2000-10-01,2000-10-03,3,2771184,2536194,234990,0
81,2000-10-04,2000-10-05,2,656262,416588,239674,0
82,2000-10-06,2000-10-10,5,3329115,2306705,1022410,0
83,2000-10-11,2000-10-15,5,4206240,4067460,138780,0
84,2000-10-16,2000-10-19,4,434604,413068,21536,0
85,2000-10-20,2000-10-21,2,1473866,1375240,98626,0
86,2000-10-22,2000-10-26,5,3731765,755835,2975930,0
87,2000-10-27,2000-10-30,4,1818556,1219108,599448,0
88,2000-10-31,2000-11-02,3,659829,315768,344061,0
89,2000-11-03,2000-11-04,2,1036390,508210,528180,0
90,2000-11-05,2000-11-08,4,2569252,760524,1808728,0
91,2000-11-09,2000-11-10,2,1721608,513394,1208214,0
92,2000-11-11,2000-11-13,3,2169681,645087,1524594,0
93,2000-11-14,2000-11-18,5,750210,679830,70380,0
94,2000-11-19,2000-11-20,2,988654,934214,54440,0
95,2000-11-21,2000-11-23,3,1538598,924780,613818,0
96,2000-11-24,2000-11-27,4,2536512,1641692,894820,0
97,2000-11-28,2000-12-01,4,2242408,1099168,1143240,0
98,2000-12-02,2000-12-04,3,2679063,2452398,226665,0
99,2000-12-05,2000-12-08,4,455808,435108,20700,0
100,2000-12-09,2000-12-13,5,1591355,1061930,529425,0
101,2000-12-14,2000-12-18,5,2139985,921555,1218430,0
102,2000-12-19,2000-12-20,2,358038,218760,139278,0
103,2000-12-21,2000-12-25,5,4085940,1346690,2739250,0
104,2000-12-26,2000-12-30,5,2956405,2383985,572420,0
105,2000-12-31,2001-01-04,5,3401765,2698550,703215,0
106,2001-01-05,2001-01-09,5,3714740,834930,2879810,0
107,2001-01-10,2001-01-11,2,1251392,706604,544788,0
108,2001-01-12,2001-01-14,3,2756352,1819629,936723,0
109,2001-01-15,2001-01-16,2,1791590,1453484,338106,0
110,2001-01-17,2001-01-19,3,2776293,2509833,266460,0
111,2001-01-20,2001-01-24,5,3463015,566640,2896375,0
112,2001-01-25,2001-01-29,5,1582015,1421010,161005,0
113,2001-01-30,2001-02-03,5,1012235,885725,126510,0
114,2001-02-04,2001-02-08,5,2085465,523125,1562340,0
115,2001-02-09,2001-02-10,2,1642066,220638,1421428,0
116,2001-02-11,2001-02-14,4,3799060,2935188,863872,0
117,2001-02-15,2001-02-19,5,4392185,2680685,1711500,0
118,2001-02-20,2001-02-24,5,1292800,897995,394805,0
119,2001-02-25,2001-02-27,3,1092333,389973,702360,0
120,2001-02-28,2001-03-01,2,1868988,339964,1529024,0
121,2001-03-02,2001-03-03,2,503772,386994,116778,0
122,2001-03-04,2001-03-05,2,280914,271684,9230,0
123,2001-03-06,2001-03-07,2,1849928,986142,863786,0
124,2001-03-08,2001-03-10,3,1908645,535641,1373004,0
125,2001-03-11,2001-03-13,3,1802766,1540032,262734,0
126,2001-03-14,2001-03-15,2,406816,240860,165956,0
127,2001-03-16,2001-03-17,2,1913428,1501020,412408,0
128,2001-03-18,2001-03-19,2,1741108,1301840,439268,0
129,2001-03-20,2001-03-23,4,614672,527796,86876,0
130,2001-03-24,2001-03-26,3,414120,410493,3627,0
131,2001-03-27,2001-03-31,5,1312435,596125,716310,0
132,2001-04-01,2001-04-05,5,1015670,536380,479290,0
133,2001-04-06,2001-04-10,5,1441250,1283350,157900,0
134,2001-04-11,2001-04-13,3,2954931,908151,2046780,0
135,2001-04-14,2001-04-16,3,2686233,800505,1885728,0
136,2001-04-17,2001-04-19,3,1048746,1044633,4113,0
137,2001-04-20,2001-04-21,2,265588,261800,3788,0
138,2001-04-22,2001-04-25,4,2539368,1494100,1045268,0
139,2001-04-26,2001-04-27,2,1717212,488042,1229170,0
140,2001-04-28,2001-05-02,5,3877610,3094230,783380,0
141,2001-05-03,2001-05-07,5,827115,772000,55115,0
142,2001-05-08,2001-05-11,4,513048,495696,17352,0
143,2001-05-12,2001-05-14,3,1215600,954540,261060,0
144,2001-05-15,2001-05-19,5,2482895,842020,1640875,0
145,2001-05-20,2001-05-22,3,1242792,1154493,88299,0
146,2001-05-23,2001-05-27,5,4779315,3776090,1003225,0
147,2001-05-28,2001-05-31,4,953272,920668,32604,0
148,2001-06-01,2001-06-03,3,2335137,1295211,1039926,0
149,2001-06-04,2001-06-06,3,1372320,378243,994077,0
150,2001-06-07,2001-06-09,3,1674801,712254,962547,0
151,2001-06-10,2001-06-14,5,3055420,1840800,1214620,0
152,2001-06-15,2001-06-18,4,2546180,1470732,1075448,0
153,2001-06-19,2001-06-23,5,1615385,1322755,292630,0
154,2001-06-24,2001-06-28,5,2130510,2098965,31545,0
155,2001-06-29,2001-07-03,5,2133115,1515765,617350,0
156,2001-07-04,2001-07-08,5,2183515,1313810,869705,0
157,2001-07-09,2001-07-12,4,1957200,1656056,301144,0
158,2001-07-13,2001-07-16,4,2799964,2413984,385980,0
159,2001-07-17,2001-07-19,3,2514186,2268834,245352,0
160,2001-07-20,2001-07-23,4,3977920,1200576,2777344,0
161,2001-07-24,2001-07-27,4,3936940,2826788,1110152,0
162,2001-07-28,2001-07-31,4,682236,514780,167456,0
163,2001-08-01,2001-08-02,2,1497046,825922,671124,0
164,2001-08-03,2001-08-04,2,1750996,201892,1549104,0
165,2001-08-05,2001-08-09,5,2430025,1045115,1384910,0
166,2001-08-10,2001-08-14,5,3892165,2923420,968745,0
167,2001-08-15,2001-08-18,4,1644532,472656,1171876,0
168,2001-08-19,2001-08-21,3,2686149,1724640,961509,0
169,2001-08-22,2001-08-24,3,2468208,303903,2164305,0
170,2001-08-25,2001-08-28,4,1656944,769088,887856,0
171,2001-08-29,2001-09-02,5,2645080,2157845,487235,0
172,2001-09-03,2001-09-04,2,1039520,445542,593978,0
173,2001-09-05,2001-09-08,4,2690212,2118708,571504,0
174,2001-09-09,2001-09-11,3,355782,309795,45987,0
175,2001-09-12,2001-09-16,5,2276490,1001425,1275065,0
176,2001-09-17,2001-09-19,3,1692765,1509999,182766,0
177,2001-09-20,2001-09-24,5,4817905,4535785,282120,0
178,2001-09-25,2001-09-28,4,1928528,1762748,165780,0
179,2001-09-29,2001-10-03,5,4465515,3445700,1019815,0
180,2001-10-04,2001-10-05,2,988984,679054,309930,0
181,2001-10-06,2001-10-09,4,1495776,904784,590992,0
182,2001-10-10,2001-10-11,2,1490948,810254,680694,0
183,2001-10-12,2001-10-13,2,591112,517122,73990,0
184,2001-10-14,2001-10-15,2,452190,272868,179322,0
185,2001-10-16,2001-10-18,3,2195307,1692504,502803,0
186,2001-10-19,2001-10-20,2,1198492,649700,548792,0
187,2001-10-21,2001-10-24,4,1063132,826052,237080,0
188,2001-10-25,2001-10-28,4,498764,419288,79476,0
189,2001-10-29,2001-11-01,4,2860720,2031596,829124,0
190,2001-11-02,2001-11-05,4,736288,687788,48500,0
191,2001-11-06,2001-11-09,4,627636,603524,24112,0
192,2001-11-10,2001-11-13,4,423620,402540,21080,0
193,2001-11-14,2001-11-17,4,1409204,1057948,351256,0
194,2001-11-18,2001-11-21,4,3962320,1184256,2778064,0
195,2001-11-22,2001-11-24,3,2016174,1538790,477384,0
196,2001-11-25,2001-11-28,4,2141444,934420,1207024,0
197,2001-11-29,2001-12-02,4,485032,451668,33364,0
198,2001-12-03,2001-12-07,5,2296950,1532830,764120,0
199,2001-12-08,2001-12-12,5,1321775,1142640,179135,0
200,2001-12-13,2001-12-17,5,2143415,1444280,699135,0
201,2001-12-18,2001-12-20,3,2850531,2688243,162288,0
202,2001-12-21,2001-12-25,5,4905655,2486365,2419290,0
203,2001-12-26,2001-12-28,3,1610778,602613,1008165,0
204,2001-12-29,2001-12-31,3,454494,329646,124848,0
205,2002-01-01,2002-01-02,2,1234362,763110,471252,0
206,2002-01-03,2002-01-05,3,2689281,2401851,287430,0
207,2002-01-06,2002-01-07,2,1685792,1276664,409128,0
208,2002-01-08,2002-01-12,5,2597155,2471460,125695,0
209,2002-01-13,2002-01-14,2,1900794,1625236,275558,0
210,2002-01-15,2002-01-18,4,3183608,1492612,1690996,0
211,2002-01-19,2002-01-23,5,4926945,2357485,2569460,0
212,2002-01-24,2002-01-26,3,2994315,570351,2423964,0
213,2002-01-27,2002-01-31,5,3139740,2409480,730260,0
214,2002-02-01,2002-02-02,2,1640364,229626,1410738,0
215,2002-02-03,2002-02-05,3,952587,934287,18300,0
216,2002-02-06,2002-02-08,3,1809438,985254,824184,0
217,2002-02-09,2002-02-13,5,2889800,1950085,939715,0
218,2002-02-14,2002-02-17,4,2639564,1060904,1578660,0
219,2002-02-18,2002-02-19,2,884888,568466,316422,0
220,2002-02-20,2002-02-23,4,2400720,964656,1436064,0
221,2002-02-24,2002-02-27,4,1514232,839564,674668,0
222,2002-02-28,2002-03-04,5,2278275,939900,1338375,0
223,2002-03-05,2002-03-09,5,3566285,2873170,693115,0
224,2002-03-10,2002-03-11,2,1809662,789672,1019990,0
225,2002-03-12,2002-03-13,2,1915736,1045458,870278,0
226,2002-03-14,2002-03-17,4,3192396,1541056,1651340,0
227,2002-03-18,2002-03-20,3,2799282,2389626,409656,0
228,2002-03-21,2002-03-24,4,3930896,3886936,43960,0
229,2002-03-25,2002-03-27,3,2982039,2466636,515403,0
230,2002-03-28,2002-03-29,2,1855696,1541312,314384,0
231,2002-03-30,2002-03-31,2,910156,470318,439838,0
232,2002-04-01,2002-04-04,4,2997936,2808612,189324,0
233,2002-04-05,2002-04-06,2,1030236,819308,210928,0
234,2002-04-07,2002-04-10,4,2142100,2112648,29452,0
235,2002-04-11,2002-04-15,5,4411685,2705695,1705990,0
236,2002-04-16,2002-04-18,3,1712211,958527,753684,0
237,2002-04-19,2002-04-21,3,2697933,811593,1886340,0
238,2002-04-22,2002-04-26,5,3308795,3193080,115715,0
239,2002-04-27,2002-04-28,2,1335986,247736,1088250,0
240,2002-04-29,2002-04-30,2,724212,402530,321682,0
241,2002-05-01,2002-05-02,2,749426,538612,210814,0
242,2002-05-03,2002-05-07,5,4985860,1704425,3281435,0
243,2002-05-08,2002-05-12,5,2575865,2516380,59485,0
244,2002-05-13,2002-05-14,2,978436,953920,24516,0
245,2002-05-15,2002-05-16,2,638904,577920,60984,0
246,2002-05-17,2002-05-20,4,3129556,2975120,154436,0
247,2002-05-21,2002-05-23,3,2031006,313998,1717008,0
248,2002-05-24,2002-05-27,4,3470788,3452424,18364,0
249,2002-05-28,2002-05-30,3,2284956,1002378,1282578,0
250,2002-05-31,2002-06-03,4,2432140,1446208,985932,0
251,2002-06-04,2002-06-07,4,3826416,1457056,2369360,0
252,2002-06-08,2002-06-09,2,1926338,1484638,441700,0
253,2002-06-10,2002-06-12,3,1138311,300792,837519,0
254,2002-06-13,2002-06-15,3,1844211,321582,1522629,0
255,2002-06-16,2002-06-20,5,3535525,2105305,1430220,0
256,2002-06-21,2002-06-25,5,3456285,500360,2955925,0
257,2002-06-26,2002-06-30,5,504665,500970,3695,0
258,2002-07-01,2002-07-02,2,986236,964306,21930,0
259,2002-07-03,2002-07-05,3,1894887,1616337,278550,0
260,2002-07-06,2002-07-10,5,2087935,568615,1519320,0
261,2002-07-11,2002-07-15,5,2021330,1843375,177955,0
262,2002-07-16,2002-07-20,5,1919020,1096655,822365,0
263,2002-07-21,2002-07-22,2,1966602,1709170,257432,0
264,2002-07-23,2002-07-26,4,3831140,2646240,1184900,0
265,2002-07-27,2002-07-28,2,835120,473426,361694,0
266,2002-07-29,2002-08-02,5,4387100,3960765,426335,0
267,2002-08-03,2002-08-05,3,1995741,1608912,386829,0
268,2002-08-06,2002-08-08,3,2632425,569913,2062512,0
269,2002-08-09,2002-08-12,4,2475756,1971956,503800,0
270,2002-08-13,2002-08-16,4,1258360,754420,503940,0
271,2002-08-17,2002-08-18,2,1661182,542508,1118674,0
272,2002-08-19,2002-08-22,4,3969132,1141100,2828032,0
273,2002-08-23,2002-08-24,2,273058,219698,53360,0
274,2002-08-25,2002-08-28,4,743760,578572,165188,0
275,2002-08-29,2002-09-02,5,1912290,1062235,850055,0
276,2002-09-03,2002-09-04,2,1535664,482720,1052944,0
277,2002-09-05,2002-09-06,2,696912,634178,62734,0
278,2002-09-07,2002-09-10,4,2528380,913516,1614864,0
279,2002-09-11,2002-09-13,3,1421925,1331298,90627,0
280,2002-09-14,2002-09-17,4,478988,471808,7180,0
281,2002-09-18,2002-09-21,4,1531372,1504132,27240,0
282,2002-09-22,2002-09-26,5,2218400,688265,1530135,0
283,2002-09-27,2002-10-01,5,4541325,4355465,185860,0
284,2002-10-02,2002-10-03,2,627312,448292,179020,0
285,2002-10-04,2002-10-05,2,1435632,796058,639574,0
286,2002-10-06,2002-10-08,3,1983957,561987,1421970,0
287,2002-10-09,2002-10-13,5,692260,530515,161745,0
288,2002-10-14,2002-10-15,2,730364,204726,525638,0
289,2002-10-16,2002-10-18,3,1444500,1214922,229578,0
290,2002-10-19,2002-10-20,2,1951276,1794684,156592,0
291,2002-10-21,2002-10-22,2,1335328,982930,352398,0
292,2002-10-23,2002-10-26,4,2559804,1423480,1136324,0
293,2002-10-27,2002-10-29,3,456060,430035,26025,0
294,2002-10-30,2002-11-03,5,3136305,1569870,1566435,0
295,2002-11-04,2002-11-05,2,1898048,544552,1353496,0
296,2002-11-06,2002-11-07,2,307170,281150,26020,0
297,2002-11-08,2002-11-11,4,2630004,2607888,22116,0
298,2002-11-12,2002-11-13,2,413628,236860,176768,0
299,2002-11-14,2002-11-17,4,3142628,2744644,397984,0
300,2002-11-18,2002-11-22,5,858565,550245,308320,0
301,2002-11-23,2002-11-27,5,3380340,1007625,2372715,0
302,2002-11-28,2002-12-01,4,3019692,1033976,1985716,0
303,2002-12-02,2002-12-03,2,861376,399596,461780,0
304,2002-12-04,2002-12-06,3,1829874,917964,911910,0
305,2002-12-07,2002-12-08,2,471692,416796,54896,0
306,2002-12-09,2002-12-12,4,648840,436192,212648,0
307,2002-12-13,2002-12-16,4,2348976,1764012,584964,0
308,2002-12-17,2002-12-19,3,2801835,2376108,425727,0
309,2002-12-20,2002-12-24,5,3574800,2841290,733510,0
310,2002-12-25,2002-12-29,5,1846510,1730880,115630,0
311,2002-12-30,2002-12-31,2,1216894,917270,299624,0
312,2003-01-01,2003-01-04,4,637192,447224,189968,0
313,2003-01-05,2003-01-08,4,1366136,856976,509160,0
314,2003-01-09,2003-01-12,4,667296,421192,246104,0
315,2003-01-13,2003-01-14,2,594848,387362,207486,0
316,2003-01-15,2003-01-17,3,1354935,1136532,218403,0
317,2003-01-18,2003-01-22,5,2468475,2151230,317245,0
318,2003-01-23,2003-01-26,4,2381604,1731996,649608,0
319,2003-01-27,2003-01-30,4,3229200,2277472,951728,0
320,2003-01-31,2003-02-03,4,3306436,1541356,1765080,0
321,2003-02-04,2003-02-07,4,1198264,611720,586544,0
322,2003-02-08,2003-02-10,3,1336971,532344,804627,0
323,2003-02-11,2003-02-15,5,705990,588340,117650,0
324,2003-02-16,2003-02-19,4,2999256,1126596,1872660,0
325,2003-02-20,2003-02-23,4,949096,761536,187560,0
326,2003-02-24,2003-02-26,3,2274657,1812933,461724,0
327,2003-02-27,2003-03-03,5,1761230,1037970,723260,0
328,2003-03-04,2003-03-05,2,273772,217316,56456,0
329,2003-03-06,2003-03-08,3,1004826,599307,405519,0
330,2003-03-09,2003-03-10,2,647418,571256,76162,0
331,2003-03-11,2003-03-14,4,1374268,1191980,182288,0
332,2003-03-15,2003-03-19,5,1267255,913975,353280,0
333,2003-03-20,2003-03-24,5,853485,666205,187280,0
334,2003-03-25,2003-03-27,3,548262,410751,137511,0
335,2003-03-28,2003-04-01,5,1841430,827535,1013895,0
336,2003-04-02,2003-04-05,4,460532,459032,1500,0
337,2003-04-06,2003-04-10,5,3363310,1076280,2287030,0
338,2003-04-11,2003-04-12,2,1851960,441884,1410076,0
339,2003-04-13,2003-04-14,2,459056,427094,31962,0
340,2003-04-15,2003-04-16,2,1975116,1660918,314198,0
341,2003-04-17,2003-04-20,4,2075856,1278384,797472,0
342,2003-04-21,2003-04-24,4,3576040,3455272,120768,0
343,2003-04-25,2003-04-29,5,902100,647365,254735,0
344,2003-04-30,2003-05-02,3,2959050,2597781,361269,0
345,2003-05-03,2003-05-06,4,2550904,2217648,333256,0
346,2003-05-07,2003-05-10,4,2709876,1379412,1330464,0
347,2003-05-11,2003-05-13,3,2772255,2450925,321330,0
348,2003-05-14,2003-05-18,5,2385665,1216330,1169335,0
349,2003-05-19,2003-05-21,3,1821222,406914,1414308,0
350,2003-05-22,2003-05-24,3,1250949,836127,414822,0
351,2003-05-25,2003-05-27,3,2740944,406149,2334795,0
352,2003-05-28,2003-05-30,3,826602,379773,446829,0
353,2003-05-31,2003-06-04,5,2275665,1576140,699525,0
354,2003-06-05,2003-06-06,2,1406354,1300844,105510,0
355,2003-06-07,2003-06-09,3,2556702,397311,2159391,0
356,2003-06-10,2003-06-11,2,1494354,795668,698686,0
357,2003-06-12,2003-06-16,5,3300140,1504165,1795975,0
358,2003-06-17,2003-06-18,2,1553352,878742,674610,0
359,2003-06-19,2003-06-22,4,3971876,2275868,1696008,0
360,2003-06-23,2003-06-25,3,2723064,511485,2211579,0
361,2003-06-26,2003-06-29,4,1399536,1133884,265652,0
362,2003-06-30,2003-07-02,3,984309,889875,94434,0
363,2003-07-03,2003-07-06,4,955908,759064,196844,0
364,2003-07-07,2003-07-08,2,445378,277040,168338,0
365,2003-07-09,2003-07-13,5,4514130,3065550,1448580,0
366,2003-07-14,2003-07-15,2,796172,215028,581144,0
367,2003-07-16,2003-07-18,3,1930152,400341,1529811,0
368,2003-07-19,2003-07-20,2,815618,767298,48320,0
369,2003-07-21,2003-07-24,4,2187916,1257456,930460,0
370,2003-07-25,2003-07-29,5,3386245,2007775,1378470,0
371,2003-07-30,2003-08-02,4,837256,805940,31316,0
372,2003-08-03,2003-08-05,3,2786016,775230,2010786,0
373,2003-08-06,2003-08-08,3,1981404,572109,1409295,0
374,2003-08-09,2003-08-12,4,1624864,871360,753504,0
375,2003-08-13,2003-08-16,4,3959572,3612936,346636,0
376,2003-08-17,2003-08-18,2,1601802,1467474,134328,0
377,2003-08-19,2003-08-21,3,1114251,375018,739233,0
378,2003-08-22,2003-08-23,2,351226,221736,129490,0
379,2003-08-24,2003-08-25,2,1976490,449656,1526834,0
380,2003-08-26,2003-08-30,5,1950605,995810,954795,0
381,2003-08-31,2003-09-03,4,631808,440964,190844,0
382,2003-09-04,2003-09-07,4,504260,486576,17684,0
383,2003-09-08,2003-09-12,5,2287475,1033330,1254145,0
384,2003-09-13,2003-09-17,5,2559800,1087615,1472185,0
385,2003-09-18,2003-09-22,5,4741000,3985550,755450,0
386,2003-09-23,2003-09-24,2,1696394,1660502,35892,0
387,2003-09-25,2003-09-29,5,503845,502045,1800,0
388,2003-09-30,2003-10-04,5,3160200,542215,2617985,0
389,2003-10-05,2003-10-09,5,2601410,2462315,139095,0
390,2003-10-10,2003-10-12,3,2047899,1369500,678399,0
391,2003-10-13,2003-10-14,2,342382,271022,71360,0
392,2003-10-15,2003-10-19,5,3329940,1390920,1939020,0
393,2003-10-20,2003-10-21,2,1404652,1306826,97826,0
394,2003-10-22,2003-10-26,5,1099990,661530,438460,0
395,2003-10-27,2003-10-30,4,1887548,926460,961088,0
396,2003-10-31,2003-11-04,5,4897145,2537545,2359600,0
397,2003-11-05,2003-11-08,4,689816,597968,91848,0
398,2003-11-09,2003-11-11,3,1502757,1477872,24885,0
399,2003-11-12,2003-11-16,5,1779905,1464970,314935,0
400,2003-11-17,2003-11-18,2,1175970,436962,739008,0
401,2003-11-19,2003-11-20,2,1517590,1033908,483682,0
402,2003-11-21,2003-11-22,2,632036,318108,313928,0
403,2003-11-23,2003-11-27,5,2632995,2323995,309000,0
404,2003-11-28,2003-12-02,5,3786425,3570595,215830,0
405,2003-12-03,2003-12-07,5,1197355,970390,226965,0
406,2003-12-08,2003-12-12,5,3529620,1053445,2476175,0
407,2003-12-13,2003-12-14,2,673730,348632,325098,0
408,2003-12-15,2003-12-18,4,2011804,914508,1097296,0
409,2003-12-19,2003-12-20,2,885218,346776,538442,0
410,2003-12-21,2003-12-25,5,2306290,930735,1375555,0
411,2003-12-26,2003-12-27,2,979810,423058,556752,0
412,2003-12-28,2003-12-29,2,381218,322994,58224,0
413,2003-12-30,2004-01-03,5,4731660,1169330,3562330,0
414,2004-01-04,2004-01-05,2,1245294,693362,551932,0
415,2004-01-06,2004-01-08,3,1016529,606855,409674,0
416,2004-01-09,2004-01-11,3,1907658,1576590,331068,0
417,2004-01-12,2004-01-16,5,4393830,4053860,339970,0
418,2004-01-17,2004-01-19,3,2642148,1270797,1371351,0
419,2004-01-20,2004-01-21,2,1173608,1072974,100634,0
420,2004-01-22,2004-01-23,2,808808,776258,32550,0
421,2004-01-24,2004-01-28,5,3590180,1686635,1903545,0
422,2004-01-29,2004-02-02,5,2380445,682830,1697615,0
423,2004-02-03,2004-02-05,3,1760742,807525,953217,0
424,2004-02-06,2004-02-10,5,1558945,1471435,87510,0
425,2004-02-11,2004-02-12,2,984534,967560,16974,0
426,2004-02-13,2004-02-17,5,4496965,705650,3791315,0
427,2004-02-18,2004-02-20,3,426891,418887,8004,0
428,2004-02-21,2004-02-25,5,3618335,3580270,38065,0
429,2004-02-26,2004-02-28,3,2038752,1346763,691989,0
430,2004-02-29,2004-03-01,2,982502,441332,541170,0
431,2004-03-02,2004-03-04,3,1218237,595047,623190,0
432,2004-03-05,2004-03-08,4,2622644,2487256,135388,0
433,2004-03-09,2004-03-11,3,1224333,911193,313140,0
434,2004-03-12,2004-03-16,5,3711440,1782500,1928940,0
435,2004-03-17,2004-03-18,2,562768,438300,124468,0
436,2004-03-19,2004-03-23,5,2366990,597995,1768995,0
437,2004-03-24,2004-03-25,2,311950,206966,104984,0
438,2004-03-26,2004-03-29,4,3572524,1527928,2044596,0
439,2004-03-30,2004-04-01,3,2764014,1778124,985890,0
440,2004-04-02,2004-04-03,2,1985004,395016,1589988,0
441,2004-04-04,2004-04-08,5,4256500,1293645,2962855,0
442,2004-04-09,2004-04-10,2,1268806,956920,311886,0
443,2004-04-11,2004-04-14,4,1316260,680876,635384,0
444,2004-04-15,2004-04-19,5,3892990,1825385,2067605,0
445,2004-04-20,2004-04-24,5,1361050,512585,848465,0
446,2004-04-25,2004-04-29,5,533645,516440,17205,0
447,2004-04-30,2004-05-03,4,2230760,1192968,1037792,0
448,2004-05-04,2004-05-06,3,1941936,1412997,528939,0
449,2004-05-07,2004-05-10,4,987328,915976,71352,0
450,2004-05-11,2004-05-12,2,1601472,519488,1081984,0
451,2004-05-13,2004-05-15,3,1531017,467289,1063728,0
452,2004-05-16,2004-05-19,4,3857068,1271864,2585204,0
453,2004-05-20,2004-05-23,4,1413160,1118532,294628,0
454,2004-05-24,2004-05-28,5,785230,773135,12095,0
455,2004-05-29,2004-06-01,4,1760548,496700,1263848,0
456,2004-06-02,2004-06-04,3,2235270,2031870,203400,0
457,2004-06-05,2004-06-06,2,1239416,1148918,90498,0
458,2004-06-07,2004-06-09,3,1698861,591912,1106949,0
459,2004-06-10,2004-06-11,2,300414,239656,60758,0
460,2004-06-12,2004-06-14,3,1066212,979791,86421,0
461,2004-06-15,2004-06-19,5,3121065,1537850,1583215,0
462,2004-06-20,2004-06-21,2,738164,206732,531432,0
463,2004-06-22,2004-06-25,4,3174708,2519052,655656,0
464,2004-06-26,2004-06-27,2,1221674,210600,1011074,0
465,2004-06-28,2004-07-01,4,1579712,1066000,513712,0
466,2004-07-02,2004-07-05,4,624228,601880,22348,0
467,2004-07-06,2004-07-08,3,1121007,573927,547080,0
468,2004-07-09,2004-07-10,2,1954024,1157090,796934,0
469,2004-07-11,2004-07-13,3,1229937,602154,627783,0
470,2004-07-14,2004-07-18,5,4839190,4419945,419245,0
471,2004-07-19,2004-07-22,4,3773244,2967096,806148,0
472,2004-07-23,2004-07-25,3,1408659,604095,804564,0
473,2004-07-26,2004-07-28,3,2092476,449391,1643085,0
474,2004-07-29,2004-08-01,4,2780188,1716048,1064140,0
475,2004-08-02,2004-08-04,3,1517175,545937,971238,0
476,2004-08-05,2004-08-06,2,708172,442672,265500,0
477,2004-08-07,2004-08-11,5,4177950,3243985,933965,0
478,2004-08-12,2004-08-13,2,756622,689932,66690,0
479,2004-08-14,2004-08-18,5,1070190,678480,391710,0
480,2004-08-19,2004-08-23,5,2731185,2589830,141355,0
481,2004-08-24,2004-08-26,3,2557197,1923669,633528,0
482,2004-08-27,2004-08-29,3,1824765,934977,889788,0
483,2004-08-30,2004-09-01,3,2314125,803838,1510287,0
484,2004-09-02,2004-09-05,4,2046520,1935976,110544,0
485,2004-09-06,2004-09-08,3,978129,916686,61443,0
486,2004-09-09,2004-09-11,3,1876512,604158,1272354,0
487,2004-09-12,2004-09-16,5,3154295,2277605,876690,0
488,2004-09-17,2004-09-18,2,331780,232606,99174,0
489,2004-09-19,2004-09-20,2,369298,322318,46980,0
490,2004-09-21,2004-09-22,2,241362,230646,10716,0
491,2004-09-23,2004-09-26,4,1982472,1551940,430532,0
492,2004-09-27,2004-09-28,2,1549286,418072,1131214,0
493,2004-09-29,2004-09-30,2,1812684,304680,1508004,0
494,2004-10-01,2004-10-04,4,537656,412608,125048,0
495,2004-10-05,2004-10-08,4,2475096,568256,1906840,0
496,2004-10-09,2004-10-11,3,1360536,784311,576225,0
497,2004-10-12,2004-10-16,5,3596225,1561585,2034640,0
498,2004-10-17,2004-10-18,2,714654,599530,115124,0
499,2004-10-19,2004-10-21,3,2410365,2168532,241833,0
500,2004-10-22,2004-10-25,4,1872496,1009344,863152,0
501,2004-10-26,2004-10-29,4,405932,402744,3188,0
502,2004-10-30,2004-11-01,3,2790135,2357433,432702,0
503,2004-11-02,2004-11-05,4,1611132,1365456,245676,0
504,2004-11-06,2004-11-10,5,3670520,3081855,588665,0
505,2004-11-11,2004-11-14,4,3524732,2994820,529912,0
506,2004-11-15,2004-11-18,4,2572768,2078776,493992,0
507,2004-11-19,2004-11-23,5,599425,596700,2725,0
508,2004-11-24,2004-11-27,4,2868300,2718852,149448,0
509,2004-11-28,2004-12-02,5,4182345,1798055,2384290,0
510,2004-12-03,2004-12-06,4,2149572,1531604,617968,0
511,2004-12-07,2004-12-11,5,1039425,536625,502800,0
512,2004-12-12,2004-12-15,4,1330652,930876,399776,0
513,2004-12-16,2004-12-20,5,4477325,2230735,2246590,0
514,2004-12-21,2004-12-25,5,1516370,1495965,20405,0
515,2004-12-26,2004-12-27,2,939820,377120,562700,0
516,2004-12-28,2004-12-29,2,1692988,1675858,17130,0
517,2004-12-30,2004-12-31,2,1272596,1256066,16530,0
518,2005-01-01,2005-01-05,5,4907305,4040320,866985,0
519,2005-01-06,2005-01-10,5,1295410,614015,681395,0
520,2005-01-11,2005-01-12,2,748382,734660,13722,0
521,2005-01-13,2005-01-17,5,4935460,2305560,2629900,0
522,2005-01-18,2005-01-19,2,925152,669994,255158,0
523,2005-01-20,2005-01-24,5,1392640,1335465,57175,0
524,2005-01-25,2005-01-27,3,544143,498009,46134,0
525,2005-01-28,2005-01-31,4,2503884,1680964,822920,0
526,2005-02-01,2005-02-03,3,2061741,1261410,800331,0
527,2005-02-04,2005-02-07,4,3125488,1145332,1980156,0
528,2005-02-08,2005-02-12,5,918440,616305,302135,0
529,2005-02-13,2005-02-17,5,2405305,2398040,7265,0
530,2005-02-18,2005-02-22,5,2230485,547210,1683275,0
531,2005-02-23,2005-02-24,2,1341480,556328,785152,0
532,2005-02-25,2005-02-28,4,2986952,2099584,887368,0
533,2005-03-01,2005-03-04,4,521948,457964,63984,0
534,2005-03-05,2005-03-06,2,1559504,368692,1190812,0
535,2005-03-07,2005-03-10,4,799020,682620,116400,0
536,2005-03-11,2005-03-14,4,3544620,2693592,851028,0
537,2005-03-15,2005-03-19,5,2511870,1410340,1101530,0
538,2005-03-20,2005-03-24,5,2394180,1195865,1198315,0
539,2005-03-25,2005-03-26,2,1943092,1277358,665734,0
540,2005-03-27,2005-03-29,3,2902689,2320644,582045,0
541,2005-03-30,2005-04-02,4,1099388,983260,116128,0
542,2005-04-03,2005-04-06,4,2335900,1926248,409652,0
543,2005-04-07,2005-04-11,5,2696165,2032450,663715,0
544,2005-04-12,2005-04-16,5,4532945,2835975,1696970,0
545,2005-04-17,2005-04-19,3,1128093,321504,806589,0
546,2005-04-20,2005-04-24,5,3928970,3649155,279815,0
547,2005-04-25,2005-04-26,2,1011890,284166,727724,0
548,2005-04-27,2005-04-30,4,675424,515456,159968,0
549,2005-05-01,2005-05-03,3,1152153,1096581,55572,0
550,2005-05-04,2005-05-05,2,649834,554756,95078,0
551,2005-05-06,2005-05-10,5,1124020,807000,317020,0
552,2005-05-11,2005-05-14,4,1879968,514716,1365252,0
553,2005-05-15,2005-05-18,4,1308128,1277840,30288,0
554,2005-05-19,2005-05-22,4,2767884,2602984,164900,0
555,2005-05-23,2005-05-24,2,797876,211330,586546,0
556,2005-05-25,2005-05-29,5,1878095,1651330,226765,0
557,2005-05-30,2005-06-02,4,2732400,464844,2267556,0
558,2005-06-03,2005-06-06,4,910312,591272,319040,0
559,2005-06-07,2005-06-10,4,1525880,783756,742124,0
560,2005-06-11,2005-06-14,4,2805456,1540772,1264684,0
561,2005-06-15,2005-06-19,5,2901885,1759800,1142085,0
562,2005-06-20,2005-06-24,5,2111830,1552945,558885,0
563,2005-06-25,2005-06-29,5,4377625,2880560,1497065,0
564,2005-06-30,2005-07-01,2,1825702,647306,1178396,0
565,2005-07-02,2005-07-04,3,1490973,732330,758643,0
566,2005-07-05,2005-07-07,3,1550877,1296870,254007,0
567,2005-07-08,2005-07-10,3,1002684,647418,355266,0
568,2005-07-11,2005-07-15,5,4628525,580130,4048395,0
569,2005-07-16,2005-07-17,2,922132,885704,36428,0
570,2005-07-18,2005-07-21,4,807920,537508,270412,0
571,2005-07-22,2005-07-24,3,1082115,408384,673731,0
572,2005-07-25,2005-07-28,4,822204,817260,4944,0
573,2005-07-29,2005-07-30,2,1901454,523954,1377500,0
574,2005-07-31,2005-08-01,2,1036114,455008,581106,0
575,2005-08-02,2005-08-05,4,1232324,568684,663640,0
576,2005-08-06,2005-08-08,3,1404042,1363209,40833,0
577,2005-08-09,2005-08-13,5,970490,731385,239105,0
578,2005-08-14,2005-08-15,2,511626,272256,239370,0
579,2005-08-16,2005-08-19,4,3517920,3028176,489744,0
580,2005-08-20,2005-08-24,5,1393600,700930,692670,0
581,2005-08-25,2005-08-29,5,2346525,1903320,443205,0
582,2005-08-30,2005-09-01,3,1367625,459060,908565,0
583,2005-09-02,2005-09-05,4,2112108,1625196,486912,0
584,2005-09-06,2005-09-09,4,1813172,1184388,628784,0
585,2005-09-10,2005-09-11,2,1808948,845534,963414,0
586,2005-09-12,2005-09-15,4,3235464,2066076,1169388,0
587,2005-09-16,2005-09-18,3,2570544,2518230,52314,0
588,2005-09-19,2005-09-23,5,2286790,919650,1367140,0
589,2005-09-24,2005-09-27,4,710912,500036,210876,0
590,2005-09-28,2005-09-29,2,1110822,727292,383530,0
591,2005-09-30,2005-10-02,3,957201,486141,471060,0
592,2005-10-03,2005-10-07,5,1032700,524255,508445,0
593,2005-10-08,2005-10-11,4,468772,463812,4960,0
594,2005-10-12,2005-10-14,3,858408,665331,193077,0
595,2005-10-15,2005-10-17,3,1553430,1291062,262368,0
596,2005-10-18,2005-10-22,5,4832325,1662405,3169920,0
597,2005-10-23,2005-10-24,2,601990,250530,351460,0
598,2005-10-25,2005-10-26,2,283330,270396,12934,0
599,2005-10-27,2005-10-28,2,1612402,419696,1192706,0
600,2005-10-29,2005-10-31,3,2558268,1845669,712599,0
601,2005-11-01,2005-11-02,2,1514514,622780,891734,0
602,2005-11-03,2005-11-06,4,2850500,2070808,779692,0
603,2005-11-07,2005-11-09,3,2962098,1721796,1240302,0
604,2005-11-10,2005-11-12,3,693117,526119,166998,0
605,2005-11-13,2005-11-16,4,656420,508168,148252,0
606,2005-11-17,2005-11-20,4,1358556,588444,770112,0
607,2005-11-21,2005-11-23,3,1243287,849513,393774,0
608,2005-11-24,2005-11-25,2,1633882,1234978,398904,0
609,2005-11-26,2005-11-30,5,1748320,1539365,208955,0
610,2005-12-01,2005-12-04,4,2053332,1921644,131688,0
611,2005-12-05,2005-12-06,2,1381030,739948,641082,0
612,2005-12-07,2005-12-09,3,828249,514215,314034,0
613,2005-12-10,2005-12-14,5,4460300,2322430,2137870,0
614,2005-12-15,2005-12-17,3,1422996,1293111,129885,0
615,2005-12-18,2005-12-19,2,537500,474806,62694,0
616,2005-12-20,2005-12-24,5,1620465,956695,663770,0
617,2005-12-25,2005-12-28,4,3677664,2729716,947948,0
618,2005-12-29,2006-01-02,5,4066300,2710435,1355865,0
619,2006-01-03,2006-01-05,3,2256777,1884927,371850,0
620,2006-01-06,2006-01-07,2,853192,206058,647134,0
621,2006-01-08,2006-01-11,4,3639432,1989564,1649868,0
622,2006-01-12,2006-01-13,2,1541486,411980,1129506,0
623,2006-01-14,2006-01-18,5,2970825,748605,2222220,0
624,2006-01-19,2006-01-21,3,1497648,1487853,9795,0
625,2006-01-22,2006-01-23,2,1783020,526334,1256686,0
626,2006-01-24,2006-01-25,2,1874812,250600,1624212,0
627,2006-01-26,2006-01-30,5,2487975,2174745,313230,0
628,2006-01-31,2006-02-04,5,4537890,3070015,1467875,0
629,2006-02-05,2006-02-09,5,2212495,1807315,405180,0
630,2006-02-10,2006-02-11,2,1107746,442948,664798,0
631,2006-02-12,2006-02-16,5,3578370,2629250,949120,0
632,2006-02-17,2006-02-19,3,2001921,1533021,468900,0
633,2006-02-20,2006-02-24,5,2454740,1611650,843090,0
634,2006-02-25,2006-02-26,2,421538,288958,132580,0
635,2006-02-27,2006-03-01,3,454575,424371,30204,0
636,2006-03-02,2006-03-03,2,288054,247294,40760,0
637,2006-03-04,2006-03-08,5,3074920,1860305,1214615,0
638,2006-03-09,2006-03-13,5,4743610,2465620,2277990,0
639,2006-03-14,2006-03-18,5,4291385,3675030,616355,0
640,2006-03-19,2006-03-22,4,613464,582640,30824,0
641,2006-03-23,2006-03-24,2,1685462,271942,1413520,0
642,2006-03-25,2006-03-28,4,2633412,2597292,36120,0
643,2006-03-29,2006-04-01,4,3356204,3197876,158328,0
644,2006-04-02,2006-04-03,2,321892,317162,4730,0
645,2006-04-04,2006-04-05,2,1504626,246144,1258482,0
646,2006-04-06,2006-04-08,3,1140867,1136403,4464,0
647,2006-04-09,2006-04-13,5,1734860,1472915,261945,0
648,2006-04-14,2006-04-16,3,2947185,1981311,965874,0
649,2006-04-17,2006-04-21,5,1859280,1717040,142240,0
650,2006-04-22,2006-04-24,3,2115465,349086,1766379,0
651,2006-04-25,2006-04-26,2,1970338,1116990,853348,0
652,2006-04-27,2006-05-01,5,1416670,645465,771205,0
653,2006-05-02,2006-05-04,3,538458,427488,110970,0
654,2006-05-05,2006-05-07,3,2620725,560202,2060523,0
655,2006-05-08,2006-05-10,3,920286,791886,128400,0
656,2006-05-11,2006-05-13,3,2038176,844239,1193937,0
657,2006-05-14,2006-05-17,4,813304,548568,264736,0
658,2006-05-18,2006-05-20,3,1728525,1415949,312576,0
659,2006-05-21,2006-05-23,3,2444643,1949652,494991,0
660,2006-05-24,2006-05-27,4,2944764,1366092,1578672,0
661,2006-05-28,2006-05-30,3,2764509,980433,1784076,0
662,2006-05-31,2006-06-02,3,2560740,448056,2112684,0
663,2006-06-03,2006-06-04,2,1925294,377384,1547910,0
664,2006-06-05,2006-06-08,4,1477428,550328,927100,0
665,2006-06-09,2006-06-12,4,2248560,1676924,571636,0
666,2006-06-13,2006-06-17,5,2482070,1483655,998415,0
667,2006-06-18,2006-06-19,2,1106372,1061148,45224,0
668,2006-06-20,2006-06-23,4,3378064,3002900,375164,0
669,2006-06-24,2006-06-25,2,1006726,611216,395510,0
670,2006-06-26,2006-06-28,3,1635909,439998,1195911,0
671,2006-06-29,2006-07-01,3,2218872,2156157,62715,0
672,2006-07-02,2006-07-03,2,554584,329204,225380,0
673,2006-07-04,2006-07-05,2,1546594,387514,1159080,0
674,2006-07-06,2006-07-07,2,1381744,699052,682692,0
675,2006-07-08,2006-07-12,5,2125425,1005020,1120405,0
676,2006-07-13,2006-07-15,3,2499930,2262000,237930,0
677,2006-07-16,2006-07-20,5,4750340,2563815,2186525,0
678,2006-07-21,2006-07-22,2,347490,270802,76688,0
679,2006-07-23,2006-07-24,2,1525392,1043620,481772,0
680,2006-07-25,2006-07-27,3,1884585,676608,1207977,0
681,2006-07-28,2006-07-29,2,323596,318026,5570,0
682,2006-07-30,2006-08-01,3,1453647,1233606,220041,0
683,2006-08-02,2006-08-06,5,3277895,780515,2497380,0
684,2006-08-07,2006-08-11,5,4637865,3326600,1311265,0
685,2006-08-12,2006-08-13,2,1373230,732156,641074,0
686,2006-08-14,2006-08-18,5,4319535,2185265,2134270,0
687,2006-08-19,2006-08-23,5,1784300,962840,821460,0
688,2006-08-24,2006-08-28,5,3735335,530410,3204925,0
689,2006-08-29,2006-08-30,2,1505286,706172,799114,0
690,2006-08-31,2006-09-04,5,512220,511090,1130,0
691,2006-09-05,2006-09-08,4,2278664,1472628,806036,0
692,2006-09-09,2006-09-11,3,1356912,826134,530778,0
693,2006-09-12,2006-09-16,5,4190035,2949400,1240635,0
694,2006-09-17,2006-09-18,2,281572,219442,62130,0
695,2006-09-19,2006-09-22,4,2588476,1251200,1337276,0
696,2006-09-23,2006-09-25,3,2576724,2416365,160359,0
697,2006-09-26,2006-09-28,3,2912496,2096970,815526,0
698,2006-09-29,2006-09-30,2,1339118,1300392,38726,0
699,2006-10-01,2006-10-05,5,1961730,1918775,42955,0
700,2006-10-06,2006-10-08,3,1597512,1060260,537252,0
701,2006-10-09,2006-10-10,2,1458484,660832,797652,0
702,2006-10-11,2006-10-12,2,1858772,401372,1457400,0
703,2006-10-13,2006-10-16,4,3833888,3738424,95464,0
704,2006-10-17,2006-10-18,2,577434,293666,283768,0
705,2006-10-19,2006-10-23,5,706815,521730,185085,0
706,2006-10-24,2006-10-28,5,3054460,1102285,1952175,0
707,2006-10-29,2006-10-30,2,697240,473460,223780,0
708,2006-10-31,2006-11-04,5,2465865,888275,1577590,0
709,2006-11-05,2006-11-09,5,2926605,2467395,459210,0
710,2006-11-10,2006-11-11,2,1509406,645712,863694,0
711,2006-11-12,2006-11-14,3,1847754,857406,990348,0
712,2006-11-15,2006-11-19,5,807480,566170,241310,0
713,2006-11-20,2006-11-21,2,578478,536656,41822,0
714,2006-11-22,2006-11-26,5,757215,748600,8615,0
715,2006-11-27,2006-11-30,4,2653956,1659940,994016,0
716,2006-12-01,2006-12-02,2,1118622,735116,383506,0
717,2006-12-03,2006-12-06,4,2524976,925992,1598984,0
718,2006-12-07,2006-12-11,5,3708695,966300,2742395,0
719,2006-12-12,2006-12-13,2,1488916,1234698,254218,0
720,2006-12-14,2006-12-16,3,2106729,445782,1660947,0
721,2006-12-17,2006-12-19,3,2218377,858453,1359924,0
722,2006-12-20,2006-12-24,5,2081070,1145300,935770,0
723,2006-12-25,2006-12-28,4,2647804,956804,1691000,0
724,2006-12-29,2007-01-01,4,3823672,3792748,30924,0
725,2007-01-02,2007-01-03,2,384020,370492,13528,0
726,2007-01-04,2007-01-06,3,646479,572400,74079,0
727,2007-01-07,2007-01-11,5,3345460,2065230,1280230,0
728,2007-01-12,2007-01-14,3,1007877,366966,640911,0
729,2007-01-15,2007-01-19,5,4085115,2507330,1577785,0
730,2007-01-20,2007-01-23,4,2920812,2443700,477112,0
731,2007-01-24,2007-01-26,3,1707018,1518648,188370,0
732,2007-01-27,2007-01-29,3,323976,316134,7842,0
733,2007-01-30,2007-01-31,2,785242,257134,528108,0
734,2007-02-01,2007-02-03,3,902901,609288,293613,0
735,2007-02-04,2007-02-08,5,3074095,2693340,380755,0
736,2007-02-09,2007-02-12,4,750572,577724,172848,0
737,2007-02-13,2007-02-16,4,2987720,2847708,140012,0
738,2007-02-17,2007-02-18,2,836822,470176,366646,0
739,2007-02-19,2007-02-20,2,1219312,877042,342270,0
740,2007-02-21,2007-02-25,5,4702685,4190690,511995,0
741,2007-02-26,2007-02-28,3,1674225,315054,1359171,0
742,2007-03-01,2007-03-03,3,969480,685449,284031,0
743,2007-03-04,2007-03-07,4,3226564,3110028,116536,0
744,2007-03-08,2007-03-11,4,1929188,1268196,660992,0
745,2007-03-12,2007-03-13,2,1508362,1114632,393730,0
746,2007-03-14,2007-03-17,4,2423352,1409084,1014268,0
747,2007-03-18,2007-03-19,2,217796,215874,1922,0
748,2007-03-20,2007-03-21,2,1957100,1705718,251382,0
749,2007-03-22,2007-03-23,2,1826746,1690870,135876,0
750,2007-03-24,2007-03-26,3,1521213,574071,947142,0
751,2007-03-27,2007-03-28,2,1139112,312832,826280,0
752,2007-03-29,2007-04-01,4,2179676,1337848,841828,0
753,2007-04-02,2007-04-05,4,655100,417708,237392,0
754,2007-04-06,2007-04-08,3,1852452,741081,1111371,0
755,2007-04-09,2007-04-12,4,766940,693360,73580,0
756,2007-04-13,2007-04-15,3,1341093,1194435,146658,0
757,2007-04-16,2007-04-17,2,1567030,287734,1279296,0
758,2007-04-18,2007-04-22,5,888500,775465,113035,0
759,2007-04-23,2007-04-27,5,642820,583725,59095,0
760,2007-04-28,2007-05-02,5,3002550,2088230,914320,0
761,2007-05-03,2007-05-04,2,201428,200438,990,0
762,2007-05-05,2007-05-08,4,2713392,470456,2242936,0
763,2007-05-09,2007-05-13,5,915830,764730,151100,0
764,2007-05-14,2007-05-18,5,2354905,749975,1604930,0
765,2007-05-19,2007-05-20,2,787000,613290,173710,0
766,2007-05-21,2007-05-22,2,920098,401340,518758,0
767,2007-05-23,2007-05-27,5,3043335,2043715,999620,0
768,2007-05-28,2007-05-30,3,2622210,626844,1995366,0
769,2007-05-31,2007-06-01,2,1579994,1113160,466834,0
770,2007-06-02,2007-06-05,4,453720,453064,656,0
771,2007-06-06,2007-06-07,2,616382,472094,144288,0
772,2007-06-08,2007-06-09,2,750800,714358,36442,0
773,2007-06-10,2007-06-11,2,1736658,332384,1404274,0
774,2007-06-12,2007-06-13,2,1358234,415542,942692,0
775,2007-06-14,2007-06-17,4,1739452,979184,760268,0
776,2007-06-18,2007-06-21,4,2762392,1097584,1664808,0
777,2007-06-22,2007-06-26,5,3283110,1567700,1715410,0
778,2007-06-27,2007-06-30,4,3790932,1776532,2014400,0
779,2007-07-01,2007-07-04,4,3167236,676740,2490496,0
780,2007-07-05,2007-07-06,2,770574,488908,281666,0
781,2007-07-07,2007-07-09,3,1899006,1036212,862794,0
782,2007-07-10,2007-07-11,2,319806,281292,38514,0
783,2007-07-12,2007-07-13,2,1464308,595134,869174,0
784,2007-07-14,2007-07-15,2,550188,321958,228230,0
785,2007-07-16,2007-07-19,4,3302368,2497680,804688,0
786,2007-07-20,2007-07-24,5,3531265,2122015,1409250,0
787,2007-07-25,2007-07-27,3,2877063,882999,1994064,0
788,2007-07-28,2007-07-30,3,2176932,492000,1684932,0
789,2007-07-31,2007-08-01,2,1625038,309548,1315490,0
790,2007-08-02,2007-08-06,5,4637040,528530,4108510,0
791,2007-08-07,2007-08-11,5,4127685,2304210,1823475,0
792,2007-08-12,2007-08-15,4,3010244,1834804,1175440,0
793,2007-08-16,2007-08-18,3,1865718,1754625,111093,0
794,2007-08-19,2007-08-23,5,2569960,1794105,775855,0
795,2007-08-24,2007-08-25,2,269652,219650,50002,0
796,2007-08-26,2007-08-30,5,3607345,3519345,88000,0
797,2007-08-31,2007-09-04,5,3659395,1086120,2573275,0
798,2007-09-05,2007-09-09,5,2533155,1356370,1176785,0
799,2007-09-10,2007-09-14,5,4700075,1494775,3205300,0
800,2007-09-15,2007-09-18,4,2191980,667964,1524016,0
801,2007-09-19,2007-09-22,4,1082248,572288,509960,0
802,2007-09-23,2007-09-25,3,1787850,1678062,109788,0
803,2007-09-26,2007-09-30,5,1721130,1132215,588915,0
804,2007-10-01,2007-10-05,5,2988815,1407175,1581640,0
805,2007-10-06,2007-10-08,3,1848249,356271,1491978,0
806,2007-10-09,2007-10-10,2,1845148,482056,1363092,0
807,2007-10-11,2007-10-14,4,1602344,1339076,263268,0
808,2007-10-15,2007-10-16,2,1572798,746136,826662,0
809,2007-10-17,2007-10-20,4,3586256,3405300,180956,0
810,2007-10-21,2007-10-22,2,554254,443788,110466,0
811,2007-10-23,2007-10-27,5,4561100,1243235,3317865,0
812,2007-10-28,2007-10-31,4,2318104,1418056,900048,0
813,2007-11-01,2007-11-03,3,2070393,1856820,213573,0
814,2007-11-04,2007-11-06,3,1800705,1061802,738903,0
815,2007-11-07,2007-11-08,2,664502,376470,288032,0
816,2007-11-09,2007-11-13,5,3963855,2386260,1577595,0
817,2007-11-14,2007-11-16,3,2774727,921324,1853403,0
818,2007-11-17,2007-11-18,2,1365046,387656,977390,0
819,2007-11-19,2007-11-20,2,527612,372974,154638,0
820,2007-11-21,2007-11-24,4,3567032,2681716,885316,0
821,2007-11-25,2007-11-26,2,558044,545360,12684,0
822,2007-11-27,2007-11-28,2,1329230,967592,361638,0
823,2007-11-29,2007-12-02,4,3840040,1375176,2464864,0
824,2007-12-03,2007-12-07,5,3960555,3405905,554650,0
825,2007-12-08,2007-12-10,3,1741791,914370,827421,0
826,2007-12-11,2007-12-14,4,948544,726336,222208,0
827,2007-12-15,2007-12-17,3,1271961,1080138,191823,0
828,2007-12-18,2007-12-19,2,1718916,478862,1240054,0
829,2007-12-20,2007-12-22,3,1523274,962967,560307,0
830,2007-12-23,2007-12-25,3,1322139,1258569,63570,0
831,2007-12-26,2007-12-29,4,2835448,2206444,629004,0
832,2007-12-30,2007-12-31,2,218840,210048,8792,0
833,2008-01-01,2008-01-05,5,4943150,3691750,1251400,0
834,2008-01-06,2008-01-10,5,4829850,1537800,3292050,0
835,2008-01-11,2008-01-14,4,2871044,1035028,1836016,0
836,2008-01-15,2008-01-19,5,3538135,1016985,2521150,0
837,2008-01-20,2008-01-24,5,3506685,3090385,416300,0
838,2008-01-25,2008-01-28,4,614120,513868,100252,0
839,2008-01-29,2008-01-31,3,2111427,308457,1802970,0
840,2008-02-01,2008-02-02,2,1539398,1372464,166934,0
841,2008-02-03,2008-02-04,2,1148010,558136,589874,0
842,2008-02-05,2008-02-06,2,788042,403108,384934,0
843,2008-02-07,2008-02-11,5,2350645,760980,1589665,0
844,2008-02-12,2008-02-15,4,2645056,2488300,156756,0
845,2008-02-16,2008-02-19,4,739036,458756,280280,0
846,2008-02-20,2008-02-24,5,4640335,3446805,1193530,0
847,2008-02-25,2008-02-29,5,1349240,773705,575535,0
848,2008-03-01,2008-03-02,2,595892,245862,350030,0
849,2008-03-03,2008-03-04,2,923450,673418,250032,0
850,2008-03-05,2008-03-08,4,2185168,689284,1495884,0
851,2008-03-09,2008-03-13,5,4030460,2988065,1042395,0
852,2008-03-14,2008-03-16,3,2836113,2109828,726285,0
853,2008-03-17,2008-03-21,5,4915135,3710970,1204165,0
854,2008-03-22,2008-03-25,4,1157288,951004,206284,0
855,2008-03-26,2008-03-28,3,1595946,1524165,71781,0
856,2008-03-29,2008-03-31,3,2157486,1237587,919899,0
857,2008-04-01,2008-04-03,3,2630367,2160069,470298,0
858,2008-04-04,2008-04-07,4,2991128,2834720,156408,0
859,2008-04-08,2008-04-10,3,451941,330105,121836,0
860,2008-04-11,2008-04-14,4,3539784,2819228,720556,0
861,2008-04-15,2008-04-19,5,3105685,2515255,590430,0
862,2008-04-20,2008-04-21,2,524590,469218,55372,0
863,2008-04-22,2008-04-24,3,2445630,560934,1884696,0
864,2008-04-25,2008-04-29,5,2291730,1023390,1268340,0
865,2008-04-30,2008-05-01,2,488390,217064,271326,0
866,2008-05-02,2008-05-04,3,970467,922302,48165,0
867,2008-05-05,2008-05-06,2,1057592,947174,110418,0
868,2008-05-07,2008-05-09,3,2114970,936747,1178223,0
869,2008-05-10,2008-05-14,5,1120450,848530,271920,0
870,2008-05-15,2008-05-17,3,515961,357693,158268,0
871,2008-05-18,2008-05-22,5,2222655,677950,1544705,0
872,2008-05-23,2008-05-25,3,1921500,1480299,441201,0
873,2008-05-26,2008-05-29,4,2355788,1744308,611480,0
874,2008-05-30,2008-06-01,3,1195248,638067,557181,0
875,2008-06-02,2008-06-06,5,1827695,1793215,34480,0
876,2008-06-07,2008-06-11,5,3152510,2368935,783575,0
877,2008-06-12,2008-06-14,3,2750667,1138752,1611915,0
878,2008-06-15,2008-06-19,5,1216995,708525,508470,0
879,2008-06-20,2008-06-22,3,1634838,486447,1148391,0
880,2008-06-23,2008-06-26,4,2362488,521936,1840552,0
881,2008-06-27,2008-07-01,5,1680205,1600790,79415,0
882,2008-07-02,2008-07-04,3,892683,618879,273804,0
883,2008-07-05,2008-07-07,3,2357631,1856598,501033,0
884,2008-07-08,2008-07-11,4,3545936,657296,2888640,0
885,2008-07-12,2008-07-14,3,673590,436344,237246,0
886,2008-07-15,2008-07-18,4,2806116,762004,2044112,0
887,2008-07-19,2008-07-23,5,2207275,1320760,886515,0
888,2008-07-24,2008-07-26,3,1601139,1008861,592278,0
889,2008-07-27,2008-07-29,3,1831440,369309,1462131,0
890,2008-07-30,2008-07-31,2,491852,392436,99416,0
891,2008-08-01,2008-08-03,3,644421,461415,183006,0
892,2008-08-04,2008-08-07,4,3191736,2444728,747008,0
893,2008-08-08,2008-08-09,2,344030,326726,17304,0
894,2008-08-10,2008-08-11,2,1742756,348116,1394640,0
895,2008-08-12,2008-08-16,5,1795285,987670,807615,0
896,2008-08-17,2008-08-19,3,2084316,1059945,1024371,0
897,2008-08-20,2008-08-21,2,1474524,550486,924038,0
898,2008-08-22,2008-08-24,3,1405527,1396284,9243,0
899,2008-08-25,2008-08-27,3,2031996,924390,1107606,0
900,2008-08-28,2008-08-29,2,1179706,1088098,91608,0
901,2008-08-30,2008-08-31,2,1968690,442190,1526500,0
902,2008-09-01,2008-09-04,4,3911780,1725704,2186076,0
903,2008-09-05,2008-09-07,3,1568262,397572,1170690,0
904,2008-09-08,2008-09-12,5,1994000,1927435,66565,0
905,2008-09-13,2008-09-17,5,4706940,4168105,538835,0
906,2008-09-18,2008-09-22,5,1451550,1246825,204725,0
907,2008-09-23,2008-09-27,5,2992250,2199810,792440,0
908,2008-09-28,2008-10-01,4,1948964,1722824,226140,0
909,2008-10-02,2008-10-03,2,373034,266826,106208,0
910,2008-10-04,2008-10-05,2,692462,320620,371842,0
911,2008-10-06,2008-10-10,5,1287720,1155435,132285,0
912,2008-10-11,2008-10-14,4,3083192,1428796,1654396,0
913,2008-10-15,2008-10-17,3,1643574,415584,1227990,0
914,2008-10-18,2008-10-21,4,3345324,1251204,2094120,0
915,2008-10-22,2008-10-25,4,812644,681944,130700,0
916,2008-10-26,2008-10-27,2,1430194,1214850,215344,0
917,2008-10-28,2008-11-01,5,3517670,3148475,369195,0
918,2008-11-02,2008-11-03,2,202470,202344,126,0
919,2008-11-04,2008-11-06,3,2065284,1874415,190869,0
920,2008-11-07,2008-11-10,4,943052,921244,21808,0
921,2008-11-11,2008-11-12,2,1363342,394658,968684,0
922,2008-11-13,2008-11-17,5,2657850,2127215,530635,0
923,2008-11-18,2008-11-19,2,1232934,834394,398540,0
924,2008-11-20,2008-11-24,5,2992110,672790,2319320,0
925,2008-11-25,2008-11-27,3,2881185,2523171,358014,0
926,2008-11-28,2008-12-01,4,1871840,1485644,386196,0
927,2008-12-02,2008-12-04,3,721215,513294,207921,0
928,2008-12-05,2008-12-09,5,4093490,3858810,234680,0
929,2008-12-10,2008-12-11,2,1335658,615440,720218,0
930,2008-12-12,2008-12-16,5,2505140,1362440,1142700,0
931,2008-12-17,2008-12-21,5,1316830,1092010,224820,0
932,2008-12-22,2008-12-24,3,1086648,958551,128097,0
933,2008-12-25,2008-12-26,2,564196,413830,150366,0
934,2008-12-27,2008-12-28,2,1542804,1358644,184160,0
935,2008-12-29,2009-01-02,5,4692385,4380340,312045,0
936,2009-01-03,2009-01-07,5,4723010,2856370,1866640,0
937,2009-01-08,2009-01-09,2,1462660,1376154,86506,0
938,2009-01-10,2009-01-14,5,4848530,2965955,1882575,0
939,2009-01-15,2009-01-18,4,1075440,579020,496420,0
940,2009-01-19,2009-01-22,4,925916,599016,326900,0
941,2009-01-23,2009-01-27,5,3468230,1405740,2062490,0
942,2009-01-28,2009-02-01,5,1682815,1178980,503835,0
943,2009-02-02,2009-02-04,3,922923,548823,374100,0
944,2009-02-05,2009-02-06,2,1676948,317730,1359218,0
945,2009-02-07,2009-02-11,5,985870,555555,430315,0
946,2009-02-12,2009-02-13,2,725200,417946,307254,0
947,2009-02-14,2009-02-18,5,4289735,2338080,1951655,0
948,2009-02-19,2009-02-20,2,862420,824740,37680,0
949,2009-02-21,2009-02-23,3,1860114,713976,1146138,0
950,2009-02-24,2009-02-28,5,1442215,614150,828065,0
951,2009-03-01,2009-03-05,5,1864500,742890,1121610,0
952,2009-03-06,2009-03-08,3,2175945,1706730,469215,0
953,2009-03-09,2009-03-12,4,761448,459420,302028,0
954,2009-03-13,2009-03-17,5,3523575,1176725,2346850,0
955,2009-03-18,2009-03-22,5,2278135,1628535,649600,0
956,2009-03-23,2009-03-26,4,1145640,982532,163108,0
957,2009-03-27,2009-03-30,4,1145092,934784,210308,0
958,2009-03-31,2009-04-03,4,3408168,2668796,739372,0
959,2009-04-04,2009-04-07,4,1837012,1134688,702324,0
960,2009-04-08,2009-04-12,5,4150620,3487965,662655,0
961,2009-04-13,2009-04-14,2,1871790,754422,1117368,0
962,2009-04-15,2009-04-18,4,1684192,712816,971376,0
963,2009-04-19,2009-04-23,5,934505,918875,15630,0
964,2009-04-24,2009-04-25,2,1844160,434822,1409338,0
965,2009-04-26,2009-04-30,5,4086765,3772290,314475,0
966,2009-05-01,2009-05-02,2,904718,709656,195062,0
967,2009-05-03,2009-05-04,2,1583398,1098102,485296,0
968,2009-05-05,2009-05-07,3,1433706,907125,526581,0
969,2009-05-08,2009-05-09,2,1717542,1514280,203262,0
970,2009-05-10,2009-05-11,2,1273200,977324,295876,0
971,2009-05-12,2009-05-13,2,553540,455628,97912,0
972,2009-05-14,2009-05-15,2,1526434,568526,957908,0
973,2009-05-16,2009-05-18,3,1914825,460014,1454811,0
974,2009-05-19,2009-05-23,5,1071975,659085,412890,0
975,2009-05-24,2009-05-27,4,2780956,2404356,376600,0
976,2009-05-28,2009-05-31,4,3174600,818964,2355636,0
977,2009-06-01,2009-06-02,2,367980,202968,165012,0
978,2009-06-03,2009-06-04,2,1352740,1255858,96882,0
979,2009-06-05,2009-06-09,5,4751160,1187725,3563435,0
980,2009-06-10,2009-06-12,3,2804472,1392648,1411824,0
981,2009-06-13,2009-06-16,4,3496168,2034920,1461248,0
982,2009-06-17,2009-06-21,5,1815750,1380245,435505,0
983,2009-06-22,2009-06-23,2,789746,400008,389738,0
984,2009-06-24,2009-06-26,3,607095,580968,26127,0
985,2009-06-27,2009-06-28,2,1873108,261014,1612094,0
986,2009-06-29,2009-07-02,4,3061440,582420,2479020,0
987,2009-07-03,2009-07-06,4,2529152,1528836,1000316,0
988,2009-07-07,2009-07-11,5,3809495,3373185,436310,0
989,2009-07-12,2009-07-15,4,3398608,1746940,1651668,0
990,2009-07-16,2009-07-19,4,894492,472100,422392,0
991,2009-07-20,2009-07-24,5,578000,530510,47490,0
992,2009-07-25,2009-07-27,3,2187150,445821,1741329,0
993,2009-07-28,2009-07-31,4,2565844,773508,1792336,0
994,2009-08-01,2009-08-05,5,1142835,777750,365085,0
995,2009-08-06,2009-08-07,2,895874,254470,641404,0
996,2009-08-08,2009-08-12,5,2347215,2021160,326055,0
997,2009-08-13,2009-08-16,4,3160424,710596,2449828,0
998,2009-08-17,2009-08-19,3,2762448,2660397,102051,0
999,2009-08-20,2009-08-22,3,2947266,956079,1991187,0
1000,2009-08-23,2009-08-24,2,1597406,1440984,156422,0
1001,2009-08-25,2009-08-29,5,2118560,1593545,525015,0
1002,2009-08-30,2009-09-03,5,954970,616715,338255,0
1003,2009-09-04,2009-09-07,4,2488720,517092,1971628,0
1004,2009-09-08,2009-09-12,5,1412275,1003800,408475,0
1005,2009-09-13,2009-09-17,5,4602020,3650500,951520,0
1006,2009-09-18,2009-09-19,2,1759456,757098,1002358,0
1007,2009-09-20,2009-09-23,4,2081348,667688,1413660,0
1008,2009-09-24,2009-09-28,5,3181625,2101710,1079915,0
1009,2009-09-29,2009-09-30,2,1016614,850018,166596,0
1010,2009-10-01,2009-10-03,3,2632920,2147514,485406,0
1011,2009-10-04,2009-10-08,5,2400085,1855770,544315,0
1012,2009-10-09,2009-10-13,5,2129685,996145,1133540,0
1013,2009-10-14,2009-10-17,4,2262184,1639732,622452,0
1014,2009-10-18,2009-10-20,3,976071,700137,275934,0
1015,2009-10-21,2009-10-22,2,1508692,691118,817574,0
1016,2009-10-23,2009-10-27,5,2334580,1334655,999925,0
1017,2009-10-28,2009-10-31,4,880980,776868,104112,0
1018,2009-11-01,2009-11-03,3,2140512,830562,1309950,0
1019,2009-11-04,2009-11-08,5,1232235,720175,512060,0
1020,2009-11-09,2009-11-11,3,674661,423666,250995,0
1021,2009-11-12,2009-11-14,3,2551593,425262,2126331,0
1022,2009-11-15,2009-11-17,3,1148118,1073835,74283,0
1023,2009-11-18,2009-11-22,5,547240,506895,40345,0
1024,2009-11-23,2009-11-24,2,1030950,790856,240094,0
1025,2009-11-25,2009-11-27,3,2053584,1857666,195918,0
1026,2009-11-28,2009-11-30,3,2470761,2461092,9669,0
1027,2009-12-01,2009-12-05,5,732360,515690,216670,0
1028,2009-12-06,2009-12-08,3,2412918,2157573,255345,0
1029,2009-12-09,2009-12-10,2,400720,237678,163042,0
1030,2009-12-11,2009-12-12,2,753546,514918,238628,0
1031,2009-12-13,2009-12-15,3,1831935,1405239,426696,0
1032,2009-12-16,2009-12-18,3,321009,312933,8076,0
1033,2009-12-19,2009-12-23,5,1630765,907300,723465,0
1034,2009-12-24,2009-12-25,2,1065778,341776,724002,0
1035,2009-12-26,2009-12-27,2,810180,361128,449052,0
1036,2009-12-28,2009-12-29,2,1178388,397302,781086,0
1037,2009-12-30,2009-12-31,2,1280066,536960,743106,0
1038,2010-01-01,2010-01-02,2,1065118,901906,163212,0
1039,2010-01-03,2010-01-06,4,2731740,1219824,1511916,0
1040,2010-01-07,2010-01-09,3,1099503,634656,464847,0
1041,2010-01-10,2010-01-11,2,540246,352876,187370,0
1042,2010-01-12,2010-01-13,2,1932820,274350,1658470,0
1043,2010-01-14,2010-01-18,5,1736510,673465,1063045,0
1044,2010-01-19,2010-01-23,5,3522750,2155280,1367470,0
1045,2010-01-24,2010-01-27,4,2378200,1742084,636116,0
1046,2010-01-28,2010-01-30,3,525192,500358,24834,0
1047,2010-01-31,2010-02-01,2,1102636,458522,644114,0
1048,2010-02-02,2010-02-05,4,2475868,1168060,1307808,0
1049,2010-02-06,2010-02-10,5,3707185,1800865,1906320,0
1050,2010-02-11,2010-02-15,5,2745745,2482985,262760,0
1051,2010-02-16,2010-02-18,3,594324,578490,15834,0
1052,2010-02-19,2010-02-20,2,950750,325368,625382,0
1053,2010-02-21,2010-02-22,2,577820,402920,174900,0
1054,2010-02-23,2010-02-25,3,1287864,353358,934506,0
1055,2010-02-26,2010-03-02,5,2203980,1822135,381845,0
1056,2010-03-03,2010-03-05,3,568203,493065,75138,0
1057,2010-03-06,2010-03-10,5,825470,655930,169540,0
1058,2010-03-11,2010-03-12,2,812212,771820,40392,0
1059,2010-03-13,2010-03-16,4,730028,707520,22508,0
1060,2010-03-17,2010-03-21,5,633345,541310,92035,0
1061,2010-03-22,2010-03-25,4,3392456,812684,2579772,0
1062,2010-03-26,2010-03-27,2,1240460,776686,463774,0
1063,2010-03-28,2010-03-30,3,1729101,400176,1328925,0
1064,2010-03-31,2010-04-04,5,1014020,869140,144880,0
1065,2010-04-05,2010-04-07,3,1698285,1586100,112185,0
1066,2010-04-08,2010-04-11,4,3049136,1581472,1467664,0
1067,2010-04-12,2010-04-14,3,1576500,743043,833457,0
1068,2010-04-15,2010-04-18,4,3133728,1018024,2115704,0
1069,2010-04-19,2010-04-21,3,2091486,1609446,482040,0
1070,2010-04-22,2010-04-23,2,1945784,1318074,627710,0
1071,2010-04-24,2010-04-27,4,1132128,706744,425384,0
1072,2010-04-28,2010-04-29,2,1768354,1164332,604022,0
1073,2010-04-30,2010-05-01,2,738878,726824,12054,0
1074,2010-05-02,2010-05-04,3,2828037,1990965,837072,0
1075,2010-05-05,2010-05-08,4,2208348,1199376,1008972,0
1076,2010-05-09,2010-05-11,3,2611992,683262,1928730,0
1077,2010-05-12,2010-05-15,4,3844216,2349880,1494336,0
1078,2010-05-16,2010-05-19,4,3249084,2002784,1246300,0
1079,2010-05-20,2010-05-24,5,3428955,712465,2716490,0
1080,2010-05-25,2010-05-29,5,3292590,2343205,949385,0
1081,2010-05-30,2010-06-03,5,3500640,3208620,292020,0
1082,2010-06-04,2010-06-06,3,816879,740754,76125,0
1083,2010-06-07,2010-06-09,3,1461804,842220,619584,0
1084,2010-06-10,2010-06-12,3,1840092,883551,956541,0
1085,2010-06-13,2010-06-16,4,3859156,3490840,368316,0
1086,2010-06-17,2010-06-20,4,1453480,1001136,452344,0
1087,2010-06-21,2010-06-24,4,838572,523148,315424,0
1088,2010-06-25,2010-06-29,5,3254135,785430,2468705,0
1089,2010-06-30,2010-07-01,2,1766322,1680044,86278,0
1090,2010-07-02,2010-07-04,3,2328378,802017,1526361,0
1091,2010-07-05,2010-07-07,3,1668126,1218084,450042,0
1092,2010-07-08,2010-07-09,2,473064,231532,241532,0
1093,2010-07-10,2010-07-14,5,4666840,4513105,153735,0
1094,2010-07-15,2010-07-18,4,3004748,2782336,222412,0
1095,2010-07-19,2010-07-20,2,1759180,657980,1101200,0
1096,2010-07-21,2010-07-24,4,744420,467396,277024,0
1097,2010-07-25,2010-07-26,2,487072,301720,185352,0
1098,2010-07-27,2010-07-29,3,2637534,541257,2096277,0
1099,2010-07-30,2010-08-02,4,3933644,1478060,2455584,0
1100,2010-08-03,2010-08-06,4,3460684,2314424,1146260,0
1101,2010-08-07,2010-08-09,3,575370,306849,268521,0
1102,2010-08-10,2010-08-13,4,1602892,1415896,186996,0
1103,2010-08-14,2010-08-16,3,661890,430773,231117,0
1104,2010-08-17,2010-08-19,3,1168056,461595,706461,0
1105,2010-08-20,2010-08-24,5,4031280,1845245,2186035,0
1106,2010-08-25,2010-08-28,4,3225796,2292892,932904,0
1107,2010-08-29,2010-08-30,2,388744,316796,71948,0
1108,2010-08-31,2010-09-01,2,1848554,462014,1386540,0
1109,2010-09-02,2010-09-04,3,2295174,956067,1339107,0
1110,2010-09-05,2010-09-06,2,873956,611392,262564,0
1111,2010-09-07,2010-09-10,4,1031052,862988,168064,0
1112,2010-09-11,2010-09-13,3,1756704,773535,983169,0
1113,2010-09-14,2010-09-18,5,4981600,1731315,3250285,0
1114,2010-09-19,2010-09-22,4,3131752,939380,2192372,0
1115,2010-09-23,2010-09-26,4,855712,792924,62788,0
1116,2010-09-27,2010-09-28,2,1277704,1240870,36834,0
1117,2010-09-29,2010-09-30,2,356334,219536,136798,0
1118,2010-10-01,2010-10-03,3,554853,417798,137055,0
1119,2010-10-04,2010-10-06,3,947973,728100,219873,0
1120,2010-10-07,2010-10-10,4,3999012,3503884,495128,0
1121,2010-10-11,2010-10-13,3,416178,333195,82983,0
1122,2010-10-14,2010-10-15,2,267290,262982,4308,0
1123,2010-10-16,2010-10-20,5,1835385,880995,954390,0
1124,2010-10-21,2010-10-24,4,935584,558608,376976,0
1125,2010-10-25,2010-10-26,2,912244,672432,239812,0
1126,2010-10-27,2010-10-29,3,2308932,1605732,703200,0
1127,2010-10-30,2010-11-02,4,2481252,1216608,1264644,0
1128,2010-11-03,2010-11-07,5,4784535,706590,4077945,0
1129,2010-11-08,2010-11-10,3,775431,615645,159786,0
1130,2010-11-11,2010-11-14,4,3534292,824496,2709796,0
1131,2010-11-15,2010-11-18,4,3515284,830196,2685088,0
1132,2010-11-19,2010-11-23,5,4172045,1968460,2203585,0
1133,2010-11-24,2010-11-25,2,1847840,519380,1328460,0
1134,2010-11-26,2010-11-29,4,2464220,1274496,1189724,0
1135,2010-11-30,2010-12-04,5,2478635,853660,1624975,0
1136,2010-12-05,2010-12-09,5,3410140,885435,2524705,0
1137,2010-12-10,2010-12-13,4,2722292,1931020,791272,0
1138,2010-12-14,2010-12-17,4,2230872,483920,1746952,0
1139,2010-12-18,2010-12-21,4,696628,598908,97720,0
1140,2010-12-22,2010-12-24,3,2596170,1510311,1085859,0
1141,2010-12-25,2010-12-29,5,4532810,4397805,135005,0
1142,2010-12-30,2010-12-31,2,1698372,249842,1448530,0
1143,2011-01-01,2011-01-02,2,334472,236280,98192,0
1144,2011-01-03,2011-01-05,3,1200357,628731,571626,0
1145,2011-01-06,2011-01-09,4,2920044,1715008,1205036,0
1146,2011-01-10,2011-01-14,5,1405410,1330420,74990,0
1147,2011-01-15,2011-01-18,4,1112352,494544,617808,0
1148,2011-01-19,2011-01-20,2,1103680,1038376,65304,0
1149,2011-01-21,2011-01-23,3,1887141,667287,1219854,0
1150,2011-01-24,2011-01-26,3,2382102,1817481,564621,0
1151,2011-01-27,2011-01-31,5,3799195,3520605,278590,0
1152,2011-02-01,2011-02-02,2,672356,670570,1786,0
1153,2011-02-03,2011-02-05,3,1895379,1100172,795207,0
1154,2011-02-06,2011-02-07,2,557330,557134,196,0
1155,2011-02-08,2011-02-10,3,1546839,1265760,281079,0
1156,2011-02-11,2011-02-13,3,356277,347937,8340,0
1157,2011-02-14,2011-02-15,2,632750,303208,329542,0
1158,2011-02-16,2011-02-19,4,2702404,2150552,551852,0
1159,2011-02-20,2011-02-21,2,1397070,638124,758946,0
1160,2011-02-22,2011-02-25,4,2860828,1078588,1782240,0
1161,2011-02-26,2011-03-01,4,2443676,2134020,309656,0
1162,2011-03-02,2011-03-04,3,2326401,1399653,926748,0
1163,2011-03-05,2011-03-07,3,635193,583608,51585,0
1164,2011-03-08,2011-03-11,4,2764588,1698908,1065680,0
1165,2011-03-12,2011-03-13,2,387096,244484,142612,0
1166,2011-03-14,2011-03-18,5,3594440,1668915,1925525,0
1167,2011-03-19,2011-03-21,3,624975,583095,41880,0
1168,2011-03-22,2011-03-26,5,4311020,2229195,2081825,0
1169,2011-03-27,2011-03-28,2,1784778,1487778,297000,0
1170,2011-03-29,2011-04-02,5,982435,884410,98025,0
1171,2011-04-03,2011-04-04,2,982886,667634,315252,0
1172,2011-04-05,2011-04-09,5,3470015,1302685,2167330,0
1173,2011-04-10,2011-04-12,3,1456695,854307,602388,0
1174,2011-04-13,2011-04-16,4,995568,894988,100580,0
1175,2011-04-17,2011-04-20,4,1656836,1255828,401008,0
1176,2011-04-21,2011-04-24,4,408676,406768,1908,0
1177,2011-04-25,2011-04-27,3,2403609,1654494,749115,0
1178,2011-04-28,2011-05-02,5,2833635,527770,2305865,0
1179,2011-05-03,2011-05-05,3,2039247,783909,1255338,0
1180,2011-05-06,2011-05-08,3,1056984,500334,556650,0
1181,2011-05-09,2011-05-12,4,2069704,755412,1314292,0
1182,2011-05-13,2011-05-17,5,1953080,1038255,914825,0
1183,2011-05-18,2011-05-20,3,1923561,373773,1549788,0
1184,2011-05-21,2011-05-24,4,1840416,1127416,713000,0
1185,2011-05-25,2011-05-27,3,1687080,1121673,565407,0
1186,2011-05-28,2011-05-31,4,1244736,769932,474804,0
1187,2011-06-01,2011-06-04,4,406588,400912,5676,0
1188,2011-06-05,2011-06-08,4,3164492,2563136,601356,0
1189,2011-06-09,2011-06-10,2,1028260,770414,257846,0
1190,2011-06-11,2011-06-12,2,938116,381330,556786,0
1191,2011-06-13,2011-06-16,4,857028,498092,358936,0
1192,2011-06-17,2011-06-20,4,1444028,1316968,127060,0
1193,2011-06-21,2011-06-25,5,2004300,1865980,138320,0
1194,2011-06-26,2011-06-28,3,1664583,743340,921243,0
1195,2011-06-29,2011-06-30,2,1564282,785424,778858,0
1196,2011-07-01,2011-07-04,4,1741540,498912,1242628,0
1197,2011-07-05,2011-07-08,4,2802712,776524,2026188,0
1198,2011-07-09,2011-07-12,4,2836880,2122504,714376,0
1199,2011-07-13,2011-07-17,5,1292115,847350,444765,0
1200,2011-07-18,2011-07-20,3,2789640,673506,2116134,0
1201,2011-07-21,2011-07-23,3,1625115,1414305,210810,0
1202,2011-07-24,2011-07-26,3,1868271,1747188,121083,0
1203,2011-07-27,2011-07-28,2,492456,316712,175744,0
1204,2011-07-29,2011-08-01,4,1640464,881832,758632,0
1205,2011-08-02,2011-08-06,5,2010345,1809340,201005,0
1206,2011-08-07,2011-08-09,3,1308297,303999,1004298,0
1207,2011-08-10,2011-08-11,2,1997364,1938180,59184,0
1208,2011-08-12,2011-08-14,3,1775163,1141125,634038,0
1209,2011-08-15,2011-08-16,2,619788,469068,150720,0
1210,2011-08-17,2011-08-21,5,3699355,2040900,1658455,0
1211,2011-08-22,2011-08-23,2,1037818,450286,587532,0
1212,2011-08-24,2011-08-25,2,1880634,1841246,39388,0
1213,2011-08-26,2011-08-30,5,3716525,722920,2993605,0
1214,2011-08-31,2011-09-04,5,3873490,1805620,2067870,0
1215,2011-09-05,2011-09-08,4,3440140,552988,2887152,0
1216,2011-09-09,2011-09-12,4,1886120,977796,908324,0
1217,2011-09-13,2011-09-14,2,1660852,1015444,645408,0
1218,2011-09-15,2011-09-17,3,693612,398955,294657,0
1219,2011-09-18,2011-09-22,5,4625920,2059935,2565985,0
1220,2011-09-23,2011-09-24,2,901972,261868,640104,0
1221,2011-09-25,2011-09-29,5,746915,503425,243490,0
1222,2011-09-30,2011-10-01,2,300030,210604,89426,0
1223,2011-10-02,2011-10-06,5,4837405,4569630,267775,0
1224,2011-10-07,2011-10-11,5,3971545,3471070,500475,0
1225,2011-10-12,2011-10-16,5,2641510,2304485,337025,0
1226,2011-10-17,2011-10-20,4,887024,634804,252220,0
1227,2011-10-21,2011-10-25,5,3950260,3560780,389480,0
1228,2011-10-26,2011-10-30,5,4835620,4719185,116435,0
1229,2011-10-31,2011-11-01,2,1290614,1236796,53818,0
1230,2011-11-02,2011-11-05,4,2348204,1200612,1147592,0
1231,2011-11-06,2011-11-07,2,1292042,1161970,130072,0
1232,2011-11-08,2011-11-09,2,1770112,547486,1222626,0
1233,2011-11-10,2011-11-13,4,2114088,1675680,438408,0
1234,2011-11-14,2011-11-16,3,2809581,1363479,1446102,0
1235,2011-11-17,2011-11-19,3,1015539,354261,661278,0
1236,2011-11-20,2011-11-24,5,4568650,4086890,481760,0
1237,2011-11-25,2011-11-26,2,1312146,344142,968004,0
1238,2011-11-27,2011-11-30,4,2043224,1306764,736460,0
1239,2011-12-01,2011-12-02,2,241308,205296,36012,0
1240,2011-12-03,2011-12-05,3,2906316,2216241,690075,0
1241,2011-12-06,2011-12-09,4,624340,515092,109248,0
1242,2011-12-10,2011-12-13,4,3202064,1314468,1887596,0
1243,2011-12-14,2011-12-17,4,2782276,862744,1919532,0
1244,2011-12-18,2011-12-19,2,1031610,252786,778824,0
1245,2011-12-20,2011-12-24,5,2033415,1727885,305530,0
1246,2011-12-25,2011-12-26,2,292558,272068,20490,0
1247,2011-12-27,2011-12-31,5,2581910,2436610,145300,0
1248,2012-01-01,2012-01-02,2,740912,550286,190626,0
1249,2012-01-03,2012-01-07,5,2679960,1369840,1310120,0
1250,2012-01-08,2012-01-10,3,2816172,1406814,1409358,0
1251,2012-01-11,2012-01-15,5,1431090,958415,472675,0
1252,2012-01-16,2012-01-17,2,1796698,1427540,369158,0
1253,2012-01-18,2012-01-21,4,488548,418956,69592,0
1254,2012-01-22,2012-01-24,3,1855416,830970,1024446,0
1255,2012-01-25,2012-01-26,2,516406,369878,146528,0
1256,2012-01-27,2012-01-30,4,860436,495940,364496,0
1257,2012-01-31,2012-02-04,5,4966220,3412830,1553390,0
1258,2012-02-05,2012-02-07,3,2028453,324789,1703664,0
1259,2012-02-08,2012-02-10,3,706383,389454,316929,0
1260,2012-02-11,2012-02-15,5,2431810,978235,1453575,0
1261,2012-02-16,2012-02-19,4,3709744,2450712,1259032,0
1262,2012-02-20,2012-02-21,2,704766,447362,257404,0
1263,2012-02-22,2012-02-23,2,942236,347164,595072,0
1264,2012-02-24,2012-02-25,2,1455464,1038152,417312,0
1265,2012-02-26,2012-03-01,5,4264190,2466985,1797205,0
1266,2012-03-02,2012-03-05,4,951184,565212,385972,0
1267,2012-03-06,2012-03-08,3,2304897,1558263,746634,0
1268,2012-03-09,2012-03-12,4,1619372,1314232,305140,0
1269,2012-03-13,2012-03-14,2,695154,332356,362798,0
1270,2012-03-15,2012-03-16,2,946026,554116,391910,0
1271,2012-03-17,2012-03-19,3,1440381,487407,952974,0
1272,2012-03-20,2012-03-24,5,1666610,821130,845480,0
1273,2012-03-25,2012-03-29,5,1698880,811830,887050,0
1274,2012-03-30,2012-04-01,3,2245980,1362663,883317,0
1275,2012-04-02,2012-04-03,2,619458,604674,14784,0
1276,2012-04-04,2012-04-07,4,3515176,2036684,1478492,0
1277,2012-04-08,2012-04-11,4,1630248,900952,729296,0
1278,2012-04-12,2012-04-15,4,1221448,847876,373572,0
1279,2012-04-16,2012-04-20,5,2551145,1905220,645925,0
1280,2012-04-21,2012-04-25,5,784405,580025,204380,0
1281,2012-04-26,2012-04-28,3,1737177,465042,1272135,0
1282,2012-04-29,2012-05-03,5,3168715,508955,2659760,0
1283,2012-05-04,2012-05-08,5,4423770,2389680,2034090,0
1284,2012-05-09,2012-05-11,3,999636,876825,122811,0
1285,2012-05-12,2012-05-13,2,864782,392306,472476,0
1286,2012-05-14,2012-05-15,2,1948860,1864428,84432,0
1287,2012-05-16,2012-05-17,2,1572852,214454,1358398,0
1288,2012-05-18,2012-05-22,5,2117050,2013420,103630,0
1289,2012-05-23,2012-05-26,4,3582740,1471824,2110916,0
1290,2012-05-27,2012-05-30,4,472180,466520,5660,0
1291,2012-05-31,2012-06-03,4,3673488,1801480,1872008,0
1292,2012-06-04,2012-06-08,5,3965500,3608460,357040,0
1293,2012-06-09,2012-06-13,5,3235320,947345,2287975,0
1294,2012-06-14,2012-06-18,5,4526080,4301235,224845,0
1295,2012-06-19,2012-06-20,2,1267432,616998,650434,0
1296,2012-06-21,2012-06-24,4,1831628,1099912,731716,0
1297,2012-06-25,2012-06-29,5,3073275,952565,2120710,0
1298,2012-06-30,2012-07-02,3,979695,674322,305373,0
1299,2012-07-03,2012-07-04,2,1271168,258220,1012948,0
1300,2012-07-05,2012-07-08,4,2733828,2717308,16520,0
1301,2012-07-09,2012-07-10,2,753162,354884,398278,0
1302,2012-07-11,2012-07-15,5,1613600,1360280,253320,0
1303,2012-07-16,2012-07-18,3,831297,340095,491202,0
1304,2012-07-19,2012-07-22,4,1941492,693356,1248136,0
1305,2012-07-23,2012-07-24,2,1721936,1542610,179326,0
1306,2012-07-25,2012-07-28,4,2337220,672776,1664444,0
1307,2012-07-29,2012-07-31,3,784167,595467,188700,0
1308,2012-08-01,2012-08-04,4,917124,587356,329768,0
1309,2012-08-05,2012-08-07,3,2237823,2022030,215793,0
1310,2012-08-08,2012-08-11,4,1407776,1092172,315604,0
1311,2012-08-12,2012-08-16,5,4207885,1667880,2540005,0
1312,2012-08-17,2012-08-18,2,1461616,566072,895544,0
1313,2012-08-19,2012-08-23,5,4798130,3533010,1265120,0
1314,2012-08-24,2012-08-28,5,1081310,1047500,33810,0
1315,2012-08-29,2012-09-01,4,3683156,1535496,2147660,0
1316,2012-09-02,2012-09-03,2,1111152,432458,678694,0
1317,2012-09-04,2012-09-07,4,720580,476768,243812,0
1318,2012-09-08,2012-09-09,2,635772,608350,27422,0
1319,2012-09-10,2012-09-14,5,3760745,1671135,2089610,0
1320,2012-09-15,2012-09-17,3,1557633,348357,1209276,0
1321,2012-09-18,2012-09-20,3,706878,664698,42180,0
1322,2012-09-21,2012-09-22,2,694878,300854,394024,0
1323,2012-09-23,2012-09-27,5,693905,599110,94795,0
1324,2012-09-28,2012-10-01,4,3949356,3670332,279024,0
1325,2012-10-02,2012-10-03,2,1408386,903872,504514,0
1326,2012-10-04,2012-10-05,2,891094,734392,156702,0
1327,2012-10-06,2012-10-07,2,467626,322582,145044,0
1328,2012-10-08,2012-10-10,3,2926749,2099799,826950,0
1329,2012-10-11,2012-10-14,4,2855884,2129416,726468,0
1330,2012-10-15,2012-10-17,3,908505,407520,500985,0
1331,2012-10-18,2012-10-22,5,4201845,1818260,2383585,0
1332,2012-10-23,2012-10-27,5,4247850,2790250,1457600,0
1333,2012-10-28,2012-10-29,2,1486170,415682,1070488,0
1334,2012-10-30,2012-10-31,2,1919856,965978,953878,0
1335,2012-11-01,2012-11-02,2,823144,736904,86240,0
1336,2012-11-03,2012-11-07,5,2624620,1520555,1104065,0
1337,2012-11-08,2012-11-10,3,2458980,1118775,1340205,0
1338,2012-11-11,2012-11-13,3,922347,368790,553557,0
1339,2012-11-14,2012-11-17,4,2202196,635668,1566528,0
1340,2012-11-18,2012-11-22,5,1836350,1267360,568990,0
1341,2012-11-23,2012-11-27,5,2609100,1016910,1592190,0
1342,2012-11-28,2012-12-02,5,1430130,689215,740915,0
1343,2012-12-03,2012-12-06,4,2441700,2073900,367800,0
1344,2012-12-07,2012-12-10,4,1168932,918224,250708,0
1345,2012-12-11,2012-12-13,3,2333076,648627,1684449,0
1346,2012-12-14,2012-12-15,2,1172564,448304,724260,0
1347,2012-12-16,2012-12-17,2,788648,250102,538546,0
1348,2012-12-18,2012-12-19,2,1330878,268746,1062132,0
1349,2012-12-20,2012-12-24,5,1326995,553475,773520,0
1350,2012-12-25,2012-12-28,4,1795372,815016,980356,0
1351,2012-12-29,2013-01-02,5,776855,661350,115505,0
1352,2013-01-03,2013-01-04,2,1005024,615386,389638,0
1353,2013-01-05,2013-01-09,5,4065340,1679780,2385560,0
1354,2013-01-10,2013-01-14,5,2321670,2068500,253170,0
1355,2013-01-15,2013-01-16,2,1193384,666042,527342,0
1356,2013-01-17,2013-01-19,3,507228,366477,140751,0
1357,2013-01-20,2013-01-21,2,397644,373222,24422,0
1358,2013-01-22,2013-01-25,4,3093520,3032528,60992,0
1359,2013-01-26,2013-01-30,5,857055,642970,214085,0
1360,2013-01-31,2013-02-03,4,1923036,790612,1132424,0
1361,2013-02-04,2013-02-07,4,1003148,464844,538304,0
1362,2013-02-08,2013-02-12,5,833020,559165,273855,0
1363,2013-02-13,2013-02-16,4,1930616,1215616,715000,0
1364,2013-02-17,2013-02-21,5,4515915,2926610,1589305,0
1365,2013-02-22,2013-02-26,5,2735445,2579835,155610,0
1366,2013-02-27,2013-03-03,5,2923170,1695170,1228000,0
1367,2013-03-04,2013-03-08,5,4417725,2547935,1869790,0
1368,2013-03-09,2013-03-11,3,1355922,453516,902406,0
1369,2013-03-12,2013-03-14,3,647550,561120,86430,0
1370,2013-03-15,2013-03-17,3,2454282,1280760,1173522,0
1371,2013-03-18,2013-03-21,4,1108836,773044,335792,0
1372,2013-03-22,2013-03-24,3,1178274,441519,736755,0
1373,2013-03-25,2013-03-27,3,1905597,1065117,840480,0
1374,2013-03-28,2013-03-31,4,430432,402892,27540,0
1375,2013-04-01,2013-04-03,3,2150319,669576,1480743,0
1376,2013-04-04,2013-04-07,4,2564636,1336724,1227912,0
1377,2013-04-08,2013-04-10,3,2799774,1580631,1219143,0
1378,2013-04-11,2013-04-15,5,4219010,4009955,209055,0
1379,2013-04-16,2013-04-20,5,1026795,868425,158370,0
1380,2013-04-21,2013-04-24,4,2651208,943564,1707644,0
1381,2013-04-25,2013-04-26,2,1376306,1099712,276594,0
1382,2013-04-27,2013-04-30,4,1869200,448152,1421048,0
1383,2013-05-01,2013-05-03,3,2388282,1723011,665271,0
1384,2013-05-04,2013-05-06,3,1119936,602172,517764,0
1385,2013-05-07,2013-05-09,3,2484027,1698810,785217,0
1386,2013-05-10,2013-05-11,2,937458,858734,78724,0
1387,2013-05-12,2013-05-13,2,984204,436950,547254,0
1388,2013-05-14,2013-05-17,4,553256,414592,138664,0
1389,2013-05-18,2013-05-19,2,1861902,275416,1586486,0
1390,2013-05-20,2013-05-22,3,2966136,1783593,1182543,0
1391,2013-05-23,2013-05-25,3,1339527,526413,813114,0
1392,2013-05-26,2013-05-27,2,1546870,473090,1073780,0
1393,2013-05-28,2013-05-29,2,250206,219370,30836,0
1394,2013-05-30,2013-06-03,5,4089370,2487255,1602115,0
1395,2013-06-04,2013-06-05,2,924878,623782,301096,0
1396,2013-06-06,2013-06-10,5,4221485,4118820,102665,0
1397,2013-06-11,2013-06-13,3,2065779,1303113,762666,0
1398,2013-06-14,2013-06-18,5,4984210,4607880,376330,0
1399,2013-06-19,2013-06-21,3,2379054,422388,1956666,0
1400,2013-06-22,2013-06-24,3,799575,392634,406941,0
1401,2013-06-25,2013-06-26,2,1699086,1696662,2424,0
1402,2013-06-27,2013-07-01,5,1581190,689195,891995,0
1403,2013-07-02,2013-07-05,4,1365476,1169276,196200,0
1404,2013-07-06,2013-07-08,3,917238,375948,541290,0
1405,2013-07-09,2013-07-13,5,930385,750905,179480,0
1406,2013-07-14,2013-07-18,5,3583450,1615080,1968370,0
1407,2013-07-19,2013-07-23,5,1303100,865105,437995,0
1408,2013-07-24,2013-07-28,5,4387925,2702620,1685305,0
1409,2013-07-29,2013-08-01,4,2105296,1641660,463636,0
1410,2013-08-02,2013-08-06,5,4944110,532275,4411835,0
1411,2013-08-07,2013-08-08,2,707788,295782,412006,0
1412,2013-08-09,2013-08-11,3,1642995,1370529,272466,0
1413,2013-08-12,2013-08-13,2,1096814,504968,591846,0
1414,2013-08-14,2013-08-17,4,1493028,556440,936588,0
1415,2013-08-18,2013-08-22,5,4371585,3036120,1335465,0
1416,2013-08-23,2013-08-24,2,263226,237688,25538,0
1417,2013-08-25,2013-08-28,4,1121800,995516,126284,0
1418,2013-08-29,2013-09-02,5,1803115,891555,911560,0
1419,2013-09-03,2013-09-04,2,1450024,212702,1237322,0
1420,2013-09-05,2013-09-07,3,2685159,883479,1801680,0
1421,2013-09-08,2013-09-12,5,1002895,544920,457975,0
1422,2013-09-13,2013-09-17,5,957715,733690,224025,0
1423,2013-09-18,2013-09-22,5,795530,768990,26540,0
1424,2013-09-23,2013-09-24,2,1907222,1094666,812556,0
1425,2013-09-25,2013-09-28,4,1347680,910944,436736,0
1426,2013-09-29,2013-10-03,5,2283220,1043215,1240005,0
1427,2013-10-04,2013-10-06,3,2339172,1342797,996375,0
1428,2013-10-07,2013-10-09,3,2018730,1529883,488847,0
1429,2013-10-10,2013-10-14,5,1337980,567690,770290,0
1430,2013-10-15,2013-10-16,2,793096,623428,169668,0
1431,2013-10-17,2013-10-21,5,699950,593975,105975,0
1432,2013-10-22,2013-10-25,4,3474304,2246008,1228296,0
1433,2013-10-26,2013-10-30,5,4603670,994295,3609375,0
1434,2013-10-31,2013-11-03,4,2407532,941460,1466072,0
1435,2013-11-04,2013-11-06,3,2229090,2117766,111324,0
1436,2013-11-07,2013-11-11,5,531170,514335,16835,0
1437,2013-11-12,2013-11-13,2,1948914,1187126,761788,0
1438,2013-11-14,2013-11-16,3,939816,302067,637749,0
1439,2013-11-17,2013-11-19,3,425901,373590,52311,0
1440,2013-11-20,2013-11-22,3,304530,300339,4191,0
1441,2013-11-23,2013-11-26,4,1827564,1569088,258476,0
1442,2013-11-27,2013-11-28,2,242680,219024,23656,0
1443,2013-11-29,2013-12-01,3,2519790,1527294,992496,0
1444,2013-12-02,2013-12-05,4,1280112,1040532,239580,0
1445,2013-12-06,2013-12-07,2,1492322,1221262,271060,0
1446,2013-12-08,2013-12-10,3,500142,425784,74358,0
1447,2013-12-11,2013-12-13,3,1170117,738273,431844,0
1448,2013-12-14,2013-12-15,2,1354828,429358,925470,0
1449,2013-12-16,2013-12-20,5,4851960,4349800,502160,0
1450,2013-12-21,2013-12-25,5,700085,516545,183540,0
1451,2013-12-26,2013-12-30,5,1977110,1376180,600930,0
1452,2013-12-31,2014-01-02,3,1917873,1544214,373659,0
1453,2014-01-03,2014-01-05,3,2123127,315075,1808052,0
1454,2014-01-06,2014-01-08,3,545625,506244,39381,0
1455,2014-01-09,2014-01-10,2,418408,304304,114104,0
1456,2014-01-11,2014-01-14,4,485144,418760,66384,0
1457,2014-01-15,2014-01-16,2,1772474,1092338,680136,0
1458,2014-01-17,2014-01-20,4,3531656,1748500,1783156,0
1459,2014-01-21,2014-01-24,4,2138036,944248,1193788,0
1460,2014-01-25,2014-01-27,3,1167069,1022910,144159,0
1461,2014-01-28,2014-01-30,3,552300,418197,134103,0
1462,2014-01-31,2014-02-04,5,2918780,2644925,273855,0
1463,2014-02-05,2014-02-07,3,2173389,1716534,456855,0
1464,2014-02-08,2014-02-10,3,1374381,719550,654831,0
1465,2014-02-11,2014-02-14,4,1717700,554860,1162840,0
1466,2014-02-15,2014-02-19,5,3875140,2995720,879420,0
1467,2014-02-20,2014-02-21,2,1164380,1128506,35874,0
1468,2014-02-22,2014-02-24,3,2082669,606396,1476273,0
1469,2014-02-25,2014-02-26,2,600670,368628,232042,0
1470,2014-02-27,2014-02-28,2,1394708,223698,1171010,0
1471,2014-03-01,2014-03-04,4,1443260,1014884,428376,0
1472,2014-03-05,2014-03-07,3,338808,337221,1587,0
1473,2014-03-08,2014-03-10,3,2174871,1771323,403548,0
1474,2014-03-11,2014-03-15,5,4706805,1590470,3116335,0
1475,2014-03-16,2014-03-19,4,3053860,2502244,551616,0
1476,2014-03-20,2014-03-22,3,2639676,378255,2261421,0
1477,2014-03-23,2014-03-27,5,1907075,662440,1244635,0
1478,2014-03-28,2014-03-29,2,1495344,833204,662140,0
1479,2014-03-30,2014-04-02,4,973044,530268,442776,0
1480,2014-04-03,2014-04-05,3,632142,358506,273636,0
1481,2014-04-06,2014-04-10,5,989165,900715,88450,0
1482,2014-04-11,2014-04-12,2,1413824,491232,922592,0
1483,2014-04-13,2014-04-15,3,1209996,346569,863427,0
1484,2014-04-16,2014-04-20,5,1355145,1071630,283515,0
1485,2014-04-21,2014-04-25,5,3261690,2715470,546220,0
1486,2014-04-26,2014-04-28,3,2879124,1702431,1176693,0
1487,2014-04-29,2014-05-01,3,1790406,1671105,119301,0
1488,2014-05-02,2014-05-04,3,2929386,1066797,1862589,0
1489,2014-05-05,2014-05-07,3,2619159,1391847,1227312,0
1490,2014-05-08,2014-05-11,4,1186728,1132900,53828,0
1491,2014-05-12,2014-05-15,4,2507180,2485896,21284,0
1492,2014-05-16,2014-05-19,4,3570544,1436464,2134080,0
1493,2014-05-20,2014-05-23,4,1752416,1388848,363568,0
1494,2014-05-24,2014-05-25,2,1316926,685450,631476,0
1495,2014-05-26,2014-05-28,3,2239308,2078865,160443,0
1496,2014-05-29,2014-05-31,3,2505534,1525266,980268,0
1497,2014-06-01,2014-06-05,5,1378080,1368945,9135,0
1498,2014-06-06,2014-06-08,3,2507016,1589268,917748,0
1499,2014-06-09,2014-06-12,4,3035400,2661984,373416,0
1500,2014-06-13,2014-06-16,4,1078844,575676,503168,0
1501,2014-06-17,2014-06-18,2,1727430,432648,1294782,0
1502,2014-06-19,2014-06-21,3,2906811,1372542,1534269,0
1503,2014-06-22,2014-06-26,5,4585815,2417345,2168470,0
1504,2014-06-27,2014-07-01,5,4559315,1384505,3174810,0
1505,2014-07-02,2014-07-03,2,861048,613538,247510,0
1506,2014-07-04,2014-07-05,2,1497760,780998,716762,0
1507,2014-07-06,2014-07-09,4,497996,488824,9172,0
1508,2014-07-10,2014-07-11,2,854510,667394,187116,0
1509,2014-07-12,2014-07-15,4,1416672,720904,695768,0
1510,2014-07-16,2014-07-19,4,1264512,1026064,238448,0
1511,2014-07-20,2014-07-24,5,2169920,1879285,290635,0
1512,2014-07-25,2014-07-26,2,1063030,656272,406758,0
1513,2014-07-27,2014-07-31,5,3313875,2269235,1044640,0
1514,2014-08-01,2014-08-05,5,1306530,1122770,183760,0
1515,2014-08-06,2014-08-10,5,3743715,1746190,1997525,0
1516,2014-08-11,2014-08-14,4,2761072,2626188,134884,0
1517,2014-08-15,2014-08-17,3,2803401,1479504,1323897,0
1518,2014-08-18,2014-08-22,5,3625200,2446575,1178625,0
1519,2014-08-23,2014-08-26,4,1687596,705592,982004,0
1520,2014-08-27,2014-08-29,3,2457414,1891989,565425,0
1521,2014-08-30,2014-09-01,3,892107,447501,444606,0
1522,2014-09-02,2014-09-06,5,2489760,2106845,382915,0
1523,2014-09-07,2014-09-10,4,626316,522584,103732,0
1524,2014-09-11,2014-09-12,2,767498,310700,456798,0
1525,2014-09-13,2014-09-17,5,648040,628630,19410,0
1526,2014-09-18,2014-09-21,4,2482680,1144520,1338160,0
1527,2014-09-22,2014-09-25,4,823632,803892,19740,0
1528,2014-09-26,2014-09-30,5,998640,547660,450980,0
1529,2014-10-01,2014-10-03,3,1377924,1094067,283857,0
1530,2014-10-04,2014-10-06,3,2351451,1949151,402300,0
1531,2014-10-07,2014-10-08,2,746020,543346,202674,0
1532,2014-10-09,2014-10-10,2,1265400,967838,297562,0
1533,2014-10-11,2014-10-15,5,4322970,3400710,922260,0
1534,2014-10-16,2014-10-20,5,1140090,613960,526130,0
1535,2014-10-21,2014-10-25,5,4555055,1408945,3146110,0
1536,2014-10-26,2014-10-29,4,2793152,2438212,354940,0
1537,2014-10-30,2014-11-02,4,1894360,910176,984184,0
1538,2014-11-03,2014-11-06,4,1775596,415364,1360232,0
1539,2014-11-07,2014-11-10,4,2892140,2632112,260028,0
1540,2014-11-11,2014-11-14,4,3048476,2438732,609744,0
1541,2014-11-15,2014-11-16,2,1328846,641196,687650,0
1542,2014-11-17,2014-11-18,2,1344172,582764,761408,0
1543,2014-11-19,2014-11-23,5,4811035,1791545,3019490,0
1544,2014-11-24,2014-11-26,3,2219448,791811,1427637,0
1545,2014-11-27,2014-11-30,4,2260864,983052,1277812,0
1546,2014-12-01,2014-12-05,5,3016005,2209330,806675,0
1547,2014-12-06,2014-12-08,3,1594959,1066866,528093,0
1548,2014-12-09,2014-12-13,5,4985035,3156420,1828615,0
1549,2014-12-14,2014-12-17,4,2616384,433480,2182904,0
1550,2014-12-18,2014-12-21,4,1511488,485544,1025944,0
1551,2014-12-22,2014-12-25,4,2337988,1232788,1105200,0
1552,2014-12-26,2014-12-30,5,2746565,1756290,990275,0
1553,2014-12-31,2015-01-03,4,3836744,3501440,335304,0
1554,2015-01-04,2015-01-07,4,2346888,513956,1832932,0
1555,2015-01-08,2015-01-11,4,3695460,3591372,104088,0
1556,2015-01-12,2015-01-13,2,1324726,692892,631834,0
1557,2015-01-14,2015-01-18,5,793060,758350,34710,0
1558,2015-01-19,2015-01-21,3,1411128,1028160,382968,0
1559,2015-01-22,2015-01-25,4,3611524,3176468,435056,0
1560,2015-01-26,2015-01-29,4,1407116,410692,996424,0
1561,2015-01-30,2015-02-02,4,3922000,1663460,2258540,0
1562,2015-02-03,2015-02-06,4,2477844,1228272,1249572,0
1563,2015-02-07,2015-02-09,3,974010,484896,489114,0
1564,2015-02-10,2015-02-14,5,4415940,2683595,1732345,0
1565,2015-02-15,2015-02-18,4,1211888,595016,616872,0
1566,2015-02-19,2015-02-23,5,1373000,779045,593955,0
1567,2015-02-24,2015-02-28,5,1711790,1534910,176880,0
1568,2015-03-01,2015-03-05,5,1861070,1671165,189905,0
1569,2015-03-06,2015-03-07,2,1708314,1606082,102232,0
1570,2015-03-08,2015-03-11,4,3705676,3539224,166452,0
1571,2015-03-12,2015-03-14,3,2277210,1802520,474690,0
1572,2015-03-15,2015-03-17,3,2953446,831855,2121591,0
1573,2015-03-18,2015-03-21,4,1648704,825848,822856,0
1574,2015-03-22,2015-03-24,3,2746629,1082640,1663989,0
1575,2015-03-25,2015-03-28,4,3711720,2546736,1164984,0
1576,2015-03-29,2015-04-02,5,4178085,1819565,2358520,0
1577,2015-04-03,2015-04-05,3,2415474,2146587,268887,0
1578,2015-04-06,2015-04-08,3,2497788,2413413,84375,0
1579,2015-04-09,2015-04-12,4,2608252,1891016,717236,0
1580,2015-04-13,2015-04-15,3,873732,653820,219912,0
1581,2015-04-16,2015-04-20,5,3556125,1826515,1729610,0
1582,2015-04-21,2015-04-25,5,4091020,3753705,337315,0
1583,2015-04-26,2015-04-28,3,553782,426156,127626,0
1584,2015-04-29,2015-05-02,4,667956,602440,65516,0
1585,2015-05-03,2015-05-05,3,475506,375600,99906,0
1586,2015-05-06,2015-05-09,4,2251964,1667688,584276,0
1587,2015-05-10,2015-05-12,3,685950,404271,281679,0
1588,2015-05-13,2015-05-16,4,3313904,564332,2749572,0
1589,2015-05-17,2015-05-20,4,2100464,1708096,392368,0
1590,2015-05-21,2015-05-24,4,830332,541228,289104,0
1591,2015-05-25,2015-05-27,3,412059,372912,39147,0
1592,2015-05-28,2015-06-01,5,1956650,937955,1018695,0
1593,2015-06-02,2015-06-05,4,3756764,3272736,484028,0
1594,2015-06-06,2015-06-08,3,1027815,568089,459726,0
1595,2015-06-09,2015-06-12,4,2455324,2033636,421688,0
1596,2015-06-13,2015-06-14,2,242352,232592,9760,0
1597,2015-06-15,2015-06-17,3,2936556,1873098,1063458,0
1598,2015-06-18,2015-06-20,3,626046,572655,53391,0
1599,2015-06-21,2015-06-24,4,444824,416088,28736,0
1600,2015-06-25,2015-06-27,3,2500920,837603,1663317,0
1601,2015-06-28,2015-06-30,3,2016669,983304,1033365,0
1602,2015-07-01,2015-07-05,5,1982190,889995,1092195,0
1603,2015-07-06,2015-07-07,2,465210,332386,132824,0
1604,2015-07-08,2015-07-10,3,583035,301725,281310,0
1605,2015-07-11,2015-07-15,5,2487150,830320,1656830,0
1606,2015-07-16,2015-07-20,5,732495,658155,74340,0
1607,2015-07-21,2015-07-23,3,993456,904596,88860,0
1608,2015-07-24,2015-07-27,4,3275672,2804936,470736,0
1609,2015-07-28,2015-08-01,5,2412995,1088175,1324820,0
1610,2015-08-02,2015-08-04,3,2848473,1877085,971388,0
1611,2015-08-05,2015-08-08,4,839892,678544,161348,0
1612,2015-08-09,2015-08-11,3,1118949,313194,805755,0
1613,2015-08-12,2015-08-16,5,1029265,885305,143960,0
1614,2015-08-17,2015-08-19,3,738105,348264,389841,0
1615,2015-08-20,2015-08-21,2,244384,219506,24878,0
1616,2015-08-22,2015-08-26,5,2860825,1271475,1589350,0
1617,2015-08-27,2015-08-28,2,1190638,1026268,164370,0
1618,2015-08-29,2015-08-30,2,853522,647980,205542,0
1619,2015-08-31,2015-09-04,5,3854675,1999305,1855370,0
1620,2015-09-05,2015-09-07,3,2646270,416280,2229990,0
1621,2015-09-08,2015-09-10,3,987360,665643,321717,0
1622,2015-09-11,2015-09-13,3,2196873,1013295,1183578,0
1623,2015-09-14,2015-09-15,2,1218652,517614,701038,0
1624,2015-09-16,2015-09-18,3,955140,932670,22470,0
1625,2015-09-19,2015-09-22,4,1341528,614548,726980,0
1626,2015-09-23,2015-09-25,3,2559750,1911369,648381,0
1627,2015-09-26,2015-09-30,5,1702450,728870,973580,0
1628,2015-10-01,2015-10-05,5,733320,583165,150155,0
1629,2015-10-06,2015-10-09,4,768920,705500,63420,0
1630,2015-10-10,2015-10-11,2,1860530,1408608,451922,0
1631,2015-10-12,2015-10-14,3,652659,560544,92115,0
1632,2015-10-15,2015-10-17,3,847695,301671,546024,0
1633,2015-10-18,2015-10-21,4,3311160,2550944,760216,0
1634,2015-10-22,2015-10-24,3,1961874,1881438,80436,0
1635,2015-10-25,2015-10-28,4,3774564,782788,2991776,0
1636,2015-10-29,2015-11-02,5,958540,585640,372900,0
1637,2015-11-03,2015-11-04,2,1840370,1621258,219112,0
1638,2015-11-05,2015-11-08,4,659824,507980,151844,0
1639,2015-11-09,2015-11-10,2,1943750,1892292,51458,0
1640,2015-11-11,2015-11-15,5,3448595,2531120,917475,0
1641,2015-11-16,2015-11-18,3,1492620,1035888,456732,0
1642,2015-11-19,2015-11-22,4,3815540,2623728,1191812,0
1643,2015-11-23,2015-11-26,4,421532,410040,11492,0
1644,2015-11-27,2015-11-30,4,1368884,1165932,202952,0
1645,2015-12-01,2015-12-05,5,4689915,4258115,431800,0
1646,2015-12-06,2015-12-08,3,1384104,1047240,336864,0
1647,2015-12-09,2015-12-13,5,1986450,881820,1104630,0
1648,2015-12-14,2015-12-16,3,2594523,926568,1667955,0
1649,2015-12-17,2015-12-21,5,2348175,707725,1640450,0
1650,2015-12-22,2015-12-26,5,890150,523975,366175,0
1651,2015-12-27,2015-12-29,3,2252160,1273518,978642,0
1652,2015-12-30,2016-01-02,4,3292812,1608400,1684412,0
1653,2016-01-03,2016-01-04,2,941248,325750,615498,0
1654,2016-01-05,2016-01-07,3,733491,646311,87180,0
1655,2016-01-08,2016-01-11,4,2075196,1820452,254744,0
1656,2016-01-12,2016-01-14,3,398793,300564,98229,0
1657,2016-01-15,2016-01-18,4,3876296,2051048,1825248,0
1658,2016-01-19,2016-01-23,5,1756970,1044015,712955,0
1659,2016-01-24,2016-01-27,4,1618604,961588,657016,0
1660,2016-01-28,2016-02-01,5,4798265,1868390,2929875,0
1661,2016-02-02,2016-02-03,2,1286218,1215114,71104,0
1662,2016-02-04,2016-02-05,2,1278692,1272702,5990,0
1663,2016-02-06,2016-02-10,5,3307005,3289275,17730,0
1664,2016-02-11,2016-02-14,4,2075964,629340,1446624,0
1665,2016-02-15,2016-02-18,4,1683424,1625264,58160,0
1666,2016-02-19,2016-02-22,4,3195912,442148,2753764,0
1667,2016-02-23,2016-02-24,2,384350,311106,73244,0
1668,2016-02-25,2016-02-28,4,3906288,3003180,903108,0
1669,2016-02-29,2016-03-01,2,1560876,800990,759886,0
1670,2016-03-02,2016-03-06,5,4854570,2790240,2064330,0
1671,2016-03-07,2016-03-10,4,600388,589192,11196,0
1672,2016-03-11,2016-03-14,4,1792076,1675676,116400,0
1673,2016-03-15,2016-03-18,4,3399928,2804760,595168,0
1674,2016-03-19,2016-03-20,2,1691560,286940,1404620,0
1675,2016-03-21,2016-03-24,4,1353172,566064,787108,0
1676,2016-03-25,2016-03-27,3,596877,579048,17829,0
1677,2016-03-28,2016-03-31,4,830444,805000,25444,0
1678,2016-04-01,2016-04-04,4,2256800,1594612,662188,0
1679,2016-04-05,2016-04-07,3,329661,328158,1503,0
1680,2016-04-08,2016-04-10,3,435048,380268,54780,0
1681,2016-04-11,2016-04-13,3,2044356,763503,1280853,0
1682,2016-04-14,2016-04-15,2,1433600,1202226,231374,0
1683,2016-04-16,2016-04-19,4,672020,515728,156292,0
1684,2016-04-20,2016-04-21,2,1303632,377562,926070,0
1685,2016-04-22,2016-04-25,4,3798512,2718952,1079560,0
1686,2016-04-26,2016-04-30,5,2721025,1825375,895650,0
1687,2016-05-01,2016-05-02,2,1531544,544954,986590,0
1688,2016-05-03,2016-05-06,4,2939932,1468744,1471188,0
1689,2016-05-07,2016-05-09,3,420792,372114,48678,0
1690,2016-05-10,2016-05-13,4,2548156,1533212,1014944,0
1691,2016-05-14,2016-05-17,4,3225244,2113096,1112148,0
1692,2016-05-18,2016-05-19,2,1520282,1065146,455136,0
1693,2016-05-20,2016-05-22,3,1594464,1485711,108753,0
1694,2016-05-23,2016-05-26,4,943712,745828,197884,0
1695,2016-05-27,2016-05-29,3,1628247,464124,1164123,0
1696,2016-05-30,2016-05-31,2,1285834,901048,384786,0
1697,2016-06-01,2016-06-04,4,1405688,445760,959928,0
1698,2016-06-05,2016-06-09,5,4157490,2158865,1998625,0
1699,2016-06-10,2016-06-12,3,2034633,1977303,57330,0
1700,2016-06-13,2016-06-17,5,3744675,2683980,1060695,0
1701,2016-06-18,2016-06-19,2,1956386,1766372,190014,0
1702,2016-06-20,2016-06-22,3,2293113,322503,1970610,0
1703,2016-06-23,2016-06-24,2,1131640,938562,193078,0
1704,2016-06-25,2016-06-28,4,3975284,2255288,1719996,0
1705,2016-06-29,2016-07-03,5,3199615,2824845,374770,0
1706,2016-07-04,2016-07-05,2,1250348,1082834,167514,0
1707,2016-07-06,2016-07-08,3,2726112,2137131,588981,0
1708,2016-07-09,2016-07-11,3,2529594,1335324,1194270,0
1709,2016-07-12,2016-07-13,2,1429480,1257148,172332,0
1710,2016-07-14,2016-07-15,2,1109064,1084042,25022,0
1711,2016-07-16,2016-07-19,4,639940,523960,115980,0
1712,2016-07-20,2016-07-24,5,1063460,663770,399690,0
1713,2016-07-25,2016-07-28,4,1323072,671416,651656,0
1714,2016-07-29,2016-08-02,5,1215345,1171295,44050,0
1715,2016-08-03,2016-08-07,5,4113955,1321100,2792855,0
1716,2016-08-08,2016-08-12,5,1839645,873830,965815,0
1717,2016-08-13,2016-08-17,5,4330660,768290,3562370,0
1718,2016-08-18,2016-08-21,4,2925648,2343720,581928,0
1719,2016-08-22,2016-08-24,3,1350732,872856,477876,0
1720,2016-08-25,2016-08-27,3,973599,442005,531594,0
1721,2016-08-28,2016-09-01,5,2744780,1833590,911190,0
1722,2016-09-02,2016-09-06,5,4050920,4041170,9750,0
1723,2016-09-07,2016-09-08,2,1290942,883870,407072,0
1724,2016-09-09,2016-09-13,5,2240645,1139140,1101505,0
1725,2016-09-14,2016-09-16,3,2272101,1823313,448788,0
1726,2016-09-17,2016-09-19,3,1860030,1318152,541878,0
1727,2016-09-20,2016-09-23,4,3046388,739924,2306464,0
1728,2016-09-24,2016-09-25,2,1308686,786960,521726,0
1729,2016-09-26,2016-09-29,4,2477956,423524,2054432,0
1730,2016-09-30,2016-10-03,4,3006068,1095896,1910172,0
1731,2016-10-04,2016-10-07,4,2406984,813852,1593132,0
1732,2016-10-08,2016-10-10,3,1226394,1206720,19674,0
1733,2016-10-11,2016-10-15,5,3067230,1057115,2010115,0
1734,2016-10-16,2016-10-18,3,1335984,1203009,132975,0
1735,2016-10-19,2016-10-21,3,1257129,794250,462879,0
1736,2016-10-22,2016-10-26,5,2635605,1560240,1075365,0
1737,2016-10-27,2016-10-31,5,3836825,3155265,681560,0
1738,2016-11-01,2016-11-04,4,1168272,1166540,1732,0
1739,2016-11-05,2016-11-06,2,1833228,551536,1281692,0
1740,2016-11-07,2016-11-11,5,2374680,1181950,1192730,0
1741,2016-11-12,2016-11-16,5,3296845,2328515,968330,0
1742,2016-11-17,2016-11-19,3,1297092,974607,322485,0
1743,2016-11-20,2016-11-24,5,2737915,2646195,91720,0
1744,2016-11-25,2016-11-28,4,671472,498256,173216,0
1745,2016-11-29,2016-11-30,2,635168,285882,349286,0
1746,2016-12-01,2016-12-04,4,2227356,1202924,1024432,0
1747,2016-12-05,2016-12-06,2,1830152,1673594,156558,0
1748,2016-12-07,2016-12-08,2,1743086,1391598,351488,0
1749,2016-12-09,2016-12-10,2,440270,279946,160324,0
1750,2016-12-11,2016-12-14,4,3224476,1296612,1927864,0
1751,2016-12-15,2016-12-18,4,1888868,1451632,437236,0
1752,2016-12-19,2016-12-21,3,2104752,978324,1126428,0
1753,2016-12-22,2016-12-24,3,1185444,712755,472689,0
1754,2016-12-25,2016-12-27,3,2612487,2247069,365418,0
1755,2016-12-28,2017-01-01,5,4110660,2386100,1724560,0
1756,2017-01-02,2017-01-06,5,4618090,2370030,2248060,0
1757,2017-01-07,2017-01-09,3,1262238,784848,477390,0
1758,2017-01-10,2017-01-13,4,3566372,540112,3026260,0
1759,2017-01-14,2017-01-18,5,2089720,513240,1576480,0
1760,2017-01-19,2017-01-22,4,2213072,1829080,383992,0
1761,2017-01-23,2017-01-24,2,650110,583558,66552,0
1762,2017-01-25,2017-01-29,5,2795180,1545465,1249715,0
1763,2017-01-30,2017-02-02,4,3451124,1377780,2073344,0
1764,2017-02-03,2017-02-05,3,2568486,1795893,772593,0
1765,2017-02-06,2017-02-09,4,2344800,1211380,1133420,0
1766,2017-02-10,2017-02-13,4,3655140,748280,2906860,0
1767,2017-02-14,2017-02-17,4,2439064,634532,1804532,0
1768,2017-02-18,2017-02-21,4,3391688,2939940,451748,0
1769,2017-02-22,2017-02-25,4,1329224,962476,366748,0
1770,2017-02-26,2017-02-28,3,2239389,1327815,911574,0
1771,2017-03-01,2017-03-04,4,1448096,974616,473480,0
1772,2017-03-05,2017-03-08,4,3576700,2427320,1149380,0
1773,2017-03-09,2017-03-10,2,1882996,743142,1139854,0
1774,2017-03-11,2017-03-14,4,790784,695308,95476,0
1775,2017-03-15,2017-03-16,2,745360,350736,394624,0
1776,2017-03-17,2017-03-20,4,3642176,3020416,621760,0
1777,2017-03-21,2017-03-22,2,1283802,1257442,26360,0
1778,2017-03-23,2017-03-24,2,1516218,615094,901124,0
1779,2017-03-25,2017-03-26,2,889722,514320,375402,0
1780,2017-03-27,2017-03-31,5,1813275,1340995,472280,0
1781,2017-04-01,2017-04-03,3,2434920,1304328,1130592,0
1782,2017-04-04,2017-04-05,2,1536652,521190,1015462,0
1783,2017-04-06,2017-04-10,5,4158450,3216260,942190,0
1784,2017-04-11,2017-04-15,5,4830675,4466440,364235,0
1785,2017-04-16,2017-04-20,5,2894195,1010505,1883690,0
1786,2017-04-21,2017-04-23,3,2456919,433095,2023824,0
1787,2017-04-24,2017-04-26,3,1308873,595476,713397,0
1788,2017-04-27,2017-04-29,3,1159818,1087608,72210,0
1789,2017-04-30,2017-05-01,2,843250,270964,572286,0
1790,2017-05-02,2017-05-04,3,452022,423267,28755,0
1791,2017-05-05,2017-05-09,5,2058960,1689820,369140,0
1792,2017-05-10,2017-05-12,3,1019082,603450,415632,0
1793,2017-05-13,2017-05-17,5,1840605,1261415,579190,0
1794,2017-05-18,2017-05-20,3,762165,308772,453393,0
1795,2017-05-21,2017-05-23,3,1683948,728640,955308,0
1796,2017-05-24,2017-05-27,4,1164096,946396,217700,0
1797,2017-05-28,2017-05-29,2,1792908,984350,808558,0
1798,2017-05-30,2017-06-01,3,1109226,880497,228729,0
1799,2017-06-02,2017-06-05,4,951952,724908,227044,0
1800,2017-06-06,2017-06-10,5,781110,662070,119040,0
1801,2017-06-11,2017-06-14,4,938988,556244,382744,0
1802,2017-06-15,2017-06-17,3,565071,415887,149184,0
1803,2017-06-18,2017-06-22,5,724670,669910,54760,0
1804,2017-06-23,2017-06-26,4,1203648,631128,572520,0
1805,2017-06-27,2017-06-29,3,1983381,1758936,224445,0
1806,2017-06-30,2017-07-02,3,2251584,709398,1542186,0
1807,2017-07-03,2017-07-04,2,1070556,608100,462456,0
1808,2017-07-05,2017-07-06,2,1281440,880784,400656,0
1809,2017-07-07,2017-07-08,2,807434,582074,225360,0
1810,2017-07-09,2017-07-13,5,4234390,2614955,1619435,0
1811,2017-07-14,2017-07-18,5,1560730,1436070,124660,0
1812,2017-07-19,2017-07-23,5,3206345,2891180,315165,0
1813,2017-07-24,2017-07-26,3,2521932,1373469,1148463,0
1814,2017-07-27,2017-07-28,2,1236066,757556,478510,0
1815,2017-07-29,2017-08-02,5,3143310,2227655,915655,0
1816,2017-08-03,2017-08-06,4,872740,792816,79924,0
1817,2017-08-07,2017-08-08,2,400060,367110,32950,0
1818,2017-08-09,2017-08-12,4,2618468,1856276,762192,0
1819,2017-08-13,2017-08-16,4,1551804,1480836,70968,0
1820,2017-08-17,2017-08-19,3,1911282,1513182,398100,0
1821,2017-08-20,2017-08-24,5,3800020,2452840,1347180,0
1822,2017-08-25,2017-08-27,3,591768,577896,13872,0
1823,2017-08-28,2017-09-01,5,3715700,1764080,1951620,0
1824,2017-09-02,2017-09-05,4,3654480,1801984,1852496,0
1825,2017-09-06,2017-09-08,3,2246064,609000,1637064,0
1826,2017-09-09,2017-09-11,3,2209728,2128488,81240,0
1827,2017-09-12,2017-09-14,3,1792053,559587,1232466,0
1828,2017-09-15,2017-09-17,3,1540164,480756,1059408,0
1829,2017-09-18,2017-09-21,4,2576832,1363456,1213376,0
1830,2017-09-22,2017-09-24,3,1839597,1381872,457725,0
1831,2017-09-25,2017-09-27,3,611133,591621,19512,0
1832,2017-09-28,2017-09-30,3,756069,609708,146361,0
1833,2017-10-01,2017-10-02,2,949378,836564,112814,0
1834,2017-10-03,2017-10-07,5,2088760,1642990,445770,0
1835,2017-10-08,2017-10-09,2,530688,477536,53152,0
1836,2017-10-10,2017-10-12,3,1485453,669876,815577,0
1837,2017-10-13,2017-10-16,4,2873024,1106328,1766696,0
1838,2017-10-17,2017-10-20,4,1163440,429680,733760,0
1839,2017-10-21,2017-10-25,5,676880,594835,82045,0
1840,2017-10-26,2017-10-30,5,1291975,1154020,137955,0
1841,2017-10-31,2017-11-01,2,1006066,326808,679258,0
1842,2017-11-02,2017-11-06,5,4115740,1195385,2920355,0
1843,2017-11-07,2017-11-10,4,2067724,707252,1360472,0
1844,2017-11-11,2017-11-13,3,2422146,1364700,1057446,0
1845,2017-11-14,2017-11-15,2,614294,353628,260666,0
1846,2017-11-16,2017-11-18,3,1065720,461565,604155,0
1847,2017-11-19,2017-11-22,4,3052540,1566396,1486144,0
1848,2017-11-23,2017-11-27,5,1288680,595405,693275,0
1849,2017-11-28,2017-11-29,2,317442,239034,78408,0
1850,2017-11-30,2017-12-02,3,1133286,821769,311517,0
1851,2017-12-03,2017-12-07,5,3385560,1824165,1561395,0
1852,2017-12-08,2017-12-11,4,3100332,3005400,94932,0
1853,2017-12-12,2017-12-15,4,2143532,2053240,90292,0
1854,2017-12-16,2017-12-19,4,525352,458796,66556,0
1855,2017-12-20,2017-12-23,4,2047948,1879824,168124,0
1856,2017-12-24,2017-12-25,2,950092,811006,139086,0
1857,2017-12-26,2017-12-29,4,2267016,1566144,700872,0
1858,2017-12-30,2018-01-02,4,826376,515520,310856,0
1859,2018-01-03,2018-01-07,5,4854435,4476640,377795,0
1860,2018-01-08,2018-01-10,3,1869753,1793490,76263,0
1861,2018-01-11,2018-01-15,5,3647310,1342820,2304490,0
1862,2018-01-16,2018-01-20,5,3720780,703065,3017715,0
1863,2018-01-21,2018-01-22,2,1013868,330966,682902,0
1864,2018-01-23,2018-01-24,2,470648,242388,228260,0
1865,2018-01-25,2018-01-29,5,760650,574030,186620,0
1866,2018-01-30,2018-02-03,5,2673235,1318545,1354690,0
1867,2018-02-04,2018-02-06,3,2169765,1790712,379053,0
1868,2018-02-07,2018-02-08,2,1153778,878542,275236,0
1869,2018-02-09,2018-02-12,4,851536,661692,189844,0
1870,2018-02-13,2018-02-14,2,1237384,452064,785320,0
1871,2018-02-15,2018-02-18,4,3891896,2071032,1820864,0
1872,2018-02-19,2018-02-20,2,1327142,647582,679560,0
1873,2018-02-21,2018-02-25,5,4699250,2854260,1844990,0
1874,2018-02-26,2018-02-28,3,2060751,640350,1420401,0
1875,2018-03-01,2018-03-02,2,318432,242752,75680,0
1876,2018-03-03,2018-03-04,2,1721992,953192,768800,0
1877,2018-03-05,2018-03-09,5,555755,507440,48315,0
1878,2018-03-10,2018-03-14,5,4399735,1509445,2890290,0
1879,2018-03-15,2018-03-17,3,1005321,371139,634182,0
1880,2018-03-18,2018-03-20,3,554361,499932,54429,0
1881,2018-03-21,2018-03-22,2,909826,700028,209798,0
1882,2018-03-23,2018-03-25,3,2665221,2596362,68859,0
1883,2018-03-26,2018-03-30,5,2018860,1797715,221145,0
1884,2018-03-31,2018-04-01,2,1601142,973092,628050,0
1885,2018-04-02,2018-04-03,2,1298524,397356,901168,0
1886,2018-04-04,2018-04-06,3,2558763,1114638,1444125,0
1887,2018-04-07,2018-04-09,3,1855005,732078,1122927,0
1888,2018-04-10,2018-04-11,2,1647944,1030200,617744,0
1889,2018-04-12,2018-04-16,5,3611605,3504020,107585,0
1890,2018-04-17,2018-04-18,2,928228,898672,29556,0
1891,2018-04-19,2018-04-21,3,2345766,1379133,966633,0
1892,2018-04-22,2018-04-26,5,3103075,843815,2259260,0
1893,2018-04-27,2018-04-28,2,504430,494686,9744,0
1894,2018-04-29,2018-05-02,4,3050452,2516124,534328,0
1895,2018-05-03,2018-05-07,5,1238280,691620,546660,0
1896,2018-05-08,2018-05-10,3,318372,300168,18204,0
1897,2018-05-11,2018-05-12,2,334142,279626,54516,0
1898,2018-05-13,2018-05-14,2,1078082,559026,519056,0
1899,2018-05-15,2018-05-17,3,1855995,1280712,575283,0
1900,2018-05-18,2018-05-20,3,1638381,950238,688143,0
1901,2018-05-21,2018-05-24,4,3780056,2929988,850068,0
1902,2018-05-25,2018-05-26,2,1668048,1406858,261190,0
1903,2018-05-27,2018-05-29,3,1044213,520233,523980,0
1904,2018-05-30,2018-06-02,4,3824988,1576084,2248904,0
1905,2018-06-03,2018-06-05,3,2442501,2097471,345030,0
1906,2018-06-06,2018-06-07,2,876374,585042,291332,0
1907,2018-06-08,2018-06-11,4,556004,464392,91612,0
1908,2018-06-12,2018-06-13,2,1604218,1411892,192326,0
1909,2018-06-14,2018-06-17,4,1010620,870916,139704,0
1910,2018-06-18,2018-06-22,5,1960770,1495810,464960,0
1911,2018-06-23,2018-06-27,5,1222900,960485,262415,0
1912,2018-06-28,2018-06-30,3,2698014,2280879,417135,0
1913,2018-07-01,2018-07-05,5,943020,921540,21480,0
1914,2018-07-06,2018-07-10,5,1932755,1489480,443275,0
1915,2018-07-11,2018-07-15,5,2339660,729785,1609875,0
1916,2018-07-16,2018-07-17,2,1427118,830336,596782,0
1917,2018-07-18,2018-07-20,3,600420,385950,214470,0
1918,2018-07-21,2018-07-23,3,1686009,1169385,516624,0
1919,2018-07-24,2018-07-28,5,810910,665635,145275,0
1920,2018-07-29,2018-07-31,3,481191,428130,53061,0
1921,2018-08-01,2018-08-05,5,1576935,695185,881750,0
1922,2018-08-06,2018-08-07,2,1218268,223306,994962,0
1923,2018-08-08,2018-08-12,5,4652285,569565,4082720,0
1924,2018-08-13,2018-08-16,4,2021912,1515460,506452,0
1925,2018-08-17,2018-08-18,2,224938,213546,11392,0
1926,2018-08-19,2018-08-23,5,3342850,3083450,259400,0
1927,2018-08-24,2018-08-26,3,977637,458013,519624,0
1928,2018-08-27,2018-08-28,2,1528852,514532,1014320,0
1929,2018-08-29,2018-08-31,3,1558539,1279356,279183,0
1930,2018-09-01,2018-09-04,4,1723744,1480312,243432,0
1931,2018-09-05,2018-09-06,2,1703150,708496,994654,0
1932,2018-09-07,2018-09-08,2,805730,584792,220938,0
1933,2018-09-09,2018-09-11,3,643926,572544,71382,0
1934,2018-09-12,2018-09-14,3,2810571,2248665,561906,0
1935,2018-09-15,2018-09-19,5,4803345,4753050,50295,0
1936,2018-09-20,2018-09-23,4,945688,762704,182984,0
1937,2018-09-24,2018-09-25,2,251964,251564,400,0
1938,2018-09-26,2018-09-28,3,2930871,1142541,1788330,0
1939,2018-09-29,2018-09-30,2,912574,441924,470650,0
1940,2018-10-01,2018-10-04,4,2522888,1686896,835992,0
1941,2018-10-05,2018-10-06,2,1463318,558662,904656,0
1942,2018-10-07,2018-10-09,3,2075583,1151487,924096,0
1943,2018-10-10,2018-10-12,3,1474659,356532,1118127,0
1944,2018-10-13,2018-10-16,4,2405556,883516,1522040,0
1945,2018-10-17,2018-10-20,4,1039184,447028,592156,0
1946,2018-10-21,2018-10-24,4,2688784,2197472,491312,0
1947,2018-10-25,2018-10-28,4,3478372,1232440,2245932,0
1948,2018-10-29,2018-11-01,4,2056188,1808732,247456,0
1949,2018-11-02,2018-11-05,4,3954080,1350884,2603196,0
1950,2018-11-06,2018-11-10,5,792920,578755,214165,0
1951,2018-11-11,2018-11-13,3,2830593,1976844,853749,0
1952,2018-11-14,2018-11-18,5,1421615,699015,722600,0
1953,2018-11-19,2018-11-23,5,1229765,698540,531225,0
1954,2018-11-24,2018-11-27,4,2566616,1399600,1167016,0
1955,2018-11-28,2018-11-29,2,1032984,517376,515608,0
1956,2018-11-30,2018-12-04,5,1389205,1049890,339315,0
1957,2018-12-05,2018-12-06,2,620446,617662,2784,0
1958,2018-12-07,2018-12-09,3,1386081,728028,658053,0
1959,2018-12-10,2018-12-14,5,3708010,762470,2945540,0
1960,2018-12-15,2018-12-16,2,820452,720704,99748,0
1961,2018-12-17,2018-12-20,4,1237816,1101872,135944,0
1962,2018-12-21,2018-12-24,4,841320,664056,177264,0
1963,2018-12-25,2018-12-26,2,1043970,977546,66424,0
1964,2018-12-27,2018-12-28,2,294206,215042,79164,0
1965,2018-12-29,2018-12-30,2,1443542,1084650,358892,0
1966,2018-12-31,2019-01-01,2,1854378,374182,1480196,0
1967,2019-01-02,2019-01-03,2,221532,211966,9566,0
1968,2019-01-04,2019-01-05,2,608196,347342,260854,0
1969,2019-01-06,2019-01-08,3,2025897,335550,1690347,0
1970,2019-01-09,2019-01-13,5,2516130,1399655,1116475,0
1971,2019-01-14,2019-01-16,3,633213,347070,286143,0
1972,2019-01-17,2019-01-20,4,1387340,1115196,272144,0
1973,2019-01-21,2019-01-23,3,1944489,1404441,540048,0
1974,2019-01-24,2019-01-25,2,1758136,1216536,541600,0
1975,2019-01-26,2019-01-29,4,704100,501648,202452,0
1976,2019-01-30,2019-02-01,3,572817,308490,264327,0
1977,2019-02-02,2019-02-04,3,2005464,420486,1584978,0
1978,2019-02-05,2019-02-09,5,4226700,1450555,2776145,0
1979,2019-02-10,2019-02-12,3,2126259,831303,1294956,0
1980,2019-02-13,2019-02-15,3,606105,472185,133920,0
1981,2019-02-16,2019-02-19,4,1257592,506332,751260,0
1982,2019-02-20,2019-02-24,5,2713335,1131820,1581515,0
1983,2019-02-25,2019-02-28,4,1049512,833556,215956,0
1984,2019-03-01,2019-03-05,5,1478745,597610,881135,0
1985,2019-03-06,2019-03-09,4,2056080,793956,1262124,0
1986,2019-03-10,2019-03-12,3,1685019,680661,1004358,0
1987,2019-03-13,2019-03-15,3,1320081,932727,387354,0
1988,2019-03-16,2019-03-19,4,3350820,3126772,224048,0
1989,2019-03-20,2019-03-24,5,4227390,1687445,2539945,0
1990,2019-03-25,2019-03-27,3,428952,332811,96141,0
1991,2019-03-28,2019-03-29,2,1189648,997114,192534,0
1992,2019-03-30,2019-04-01,3,2530584,2121882,408702,0
1993,2019-04-02,2019-04-05,4,1747584,1440752,306832,0
1994,2019-04-06,2019-04-07,2,1554450,1223360,331090,0
1995,2019-04-08,2019-04-11,4,2119580,1052240,1067340,0
1996,2019-04-12,2019-04-15,4,2715368,536796,2178572,0
1997,2019-04-16,2019-04-19,4,2665600,1544900,1120700,0
1998,2019-04-20,2019-04-21,2,1610040,1341268,268772,0
1999,2019-04-22,2019-04-24,3,1495092,1492797,2295,0
2000,2019-04-25,2019-04-29,5,1296370,844230,452140,0
2001,2019-04-30,2019-05-03,4,2648464,2477400,171064,0
2002,2019-05-04,2019-05-08,5,4084980,3895710,189270,0
2003,2019-05-09,2019-05-11,3,910071,799053,111018,0
2004,2019-05-12,2019-05-16,5,4252245,1316220,2936025,0
2005,2019-05-17,2019-05-20,4,3608668,3397848,210820,0
2006,2019-05-21,2019-05-22,2,1907550,541948,1365602,0
2007,2019-05-23,2019-05-27,5,989990,742735,247255,0
2008,2019-05-28,2019-05-30,3,1703970,575412,1128558,0
2009,2019-05-31,2019-06-04,5,2573395,2454630,118765,0
2010,2019-06-05,2019-06-07,3,2717955,541293,2176662,0
2011,2019-06-08,2019-06-12,5,4427065,1232130,3194935,0
2012,2019-06-13,2019-06-15,3,2032572,1425156,607416,0
2013,2019-06-16,2019-06-19,4,3511108,3061364,449744,0
2014,2019-06-20,2019-06-21,2,1628498,1167184,461314,0
2015,2019-06-22,2019-06-26,5,4093630,2467130,1626500,0
2016,2019-06-27,2019-06-29,3,584022,401826,182196,0
2017,2019-06-30,2019-07-02,3,658758,328236,330522,0
2018,2019-07-03,2019-07-06,4,1476768,898884,577884,0
2019,2019-07-07,2019-07-09,3,2103186,1624491,478695,0
2020,2019-07-10,2019-07-12,3,1155204,817173,338031,0
2021,2019-07-13,2019-07-16,4,3272924,1890384,1382540,0
2022,2019-07-17,2019-07-20,4,2445764,1402028,1043736,0
2023,2019-07-21,2019-07-22,2,1571094,754036,817058,0
2024,2019-07-23,2019-07-24,2,528656,255644,273012,0
2025,2019-07-25,2019-07-28,4,3607352,2266292,1341060,0
2026,2019-07-29,2019-08-02,5,1658095,833275,824820,0
2027,2019-08-03,2019-08-04,2,1750612,1304518,446094,0
2028,2019-08-05,2019-08-07,3,594240,398127,196113,0
2029,2019-08-08,2019-08-12,5,4742645,1239430,3503215,0
2030,2019-08-13,2019-08-16,4,2281408,2071612,209796,0
2031,2019-08-17,2019-08-20,4,1293848,681972,611876,0
2032,2019-08-21,2019-08-25,5,509750,508570,1180,0
2033,2019-08-26,2019-08-30,5,4932160,3612440,1319720,0
2034,2019-08-31,2019-09-01,2,236528,230070,6458,0
2035,2019-09-02,2019-09-04,3,2199426,1002372,1197054,0
2036,2019-09-05,2019-09-07,3,1024686,362100,662586,0
2037,2019-09-08,2019-09-12,5,2968355,677695,2290660,0
2038,2019-09-13,2019-09-16,4,3663928,801812,2862116,0
2039,2019-09-17,2019-09-18,2,1114942,686314,428628,0
2040,2019-09-19,2019-09-23,5,4162705,3196505,966200,0
2041,2019-09-24,2019-09-25,2,1396742,1025500,371242,0
2042,2019-09-26,2019-09-28,3,2562387,1022874,1539513,0
2043,2019-09-29,2019-10-01,3,1498719,1447104,51615,0
2044,2019-10-02,2019-10-06,5,702560,522550,180010,0
2045,2019-10-07,2019-10-10,4,3514624,1838592,1676032,0
2046,2019-10-11,2019-10-14,4,3893324,1949864,1943460,0
2047,2019-10-15,2019-10-19,5,4062870,1576970,2485900,0
2048,2019-10-20,2019-10-21,2,1762202,1750188,12014,0
2049,2019-10-22,2019-10-26,5,1313260,1146155,167105,0
2050,2019-10-27,2019-10-28,2,1928424,246312,1682112,0
2051,2019-10-29,2019-10-31,3,1198791,950532,248259,0
2052,2019-11-01,2019-11-05,5,3599655,2547015,1052640,0
2053,2019-11-06,2019-11-07,2,456970,352632,104338,0
2054,2019-11-08,2019-11-10,3,2902197,560631,2341566,0
2055,2019-11-11,2019-11-13,3,1241307,1126200,115107,0
2056,2019-11-14,2019-11-16,3,1417887,1302579,115308,0
2057,2019-11-17,2019-11-19,3,2412837,862962,1549875,0
2058,2019-11-20,2019-11-24,5,3367570,1059195,2308375,0
2059,2019-11-25,2019-11-28,4,2632860,2454944,177916,0
2060,2019-11-29,2019-12-02,4,2019276,1991604,27672,0
2061,2019-12-03,2019-12-05,3,2004474,1524207,480267,0
2062,2019-12-06,2019-12-08,3,669552,426603,242949,0
2063,2019-12-09,2019-12-12,4,1944236,1184228,760008,0
2064,2019-12-13,2019-12-15,3,2196378,1627140,569238,0
2065,2019-12-16,2019-12-20,5,3741245,1652455,2088790,0
2066,2019-12-21,2019-12-25,5,1035170,539685,495485,0
2067,2019-12-26,2019-12-27,2,1200854,997220,203634,0
2068,2019-12-28,2019-12-30,3,1860525,813189,1047336,0
2069,2019-12-31,2020-01-04,5,3113375,721315,2392060,0
2070,2020-01-05,2020-01-08,4,3062756,1520912,1541844,0
2071,2020-01-09,2020-01-13,5,1772215,1063155,709060,0
2072,2020-01-14,2020-01-17,4,3938368,2704344,1234024,0
2073,2020-01-18,2020-01-20,3,958686,505416,453270,0
2074,2020-01-21,2020-01-24,4,2759096,2556796,202300,0
2075,2020-01-25,2020-01-28,4,1804932,1246400,558532,0
2076,2020-01-29,2020-02-01,4,1564000,1503756,60244,0
2077,2020-02-02,2020-02-03,2,634070,609472,24598,0
2078,2020-02-04,2020-02-07,4,479648,446616,33032,0
2079,2020-02-08,2020-02-12,5,1219605,1170790,48815,0
2080,2020-02-13,2020-02-15,3,1665078,301497,1363581,0
2081,2020-02-16,2020-02-18,3,1929657,927981,1001676,0
2082,2020-02-19,2020-02-23,5,2733660,2656090,77570,0
2083,2020-02-24,2020-02-25,2,871264,594732,276532,0
2084,2020-02-26,2020-02-29,4,3769180,706812,3062368,0
2085,2020-03-01,2020-03-04,4,3504956,2089588,1415368,0
2086,2020-03-05,2020-03-07,3,932565,354090,578475,0
2087,2020-03-08,2020-03-09,2,758984,326524,432460,0
2088,2020-03-10,2020-03-14,5,2842150,2840725,1425,0
2089,2020-03-15,2020-03-16,2,288440,273054,15386,0
2090,2020-03-17,2020-03-19,3,2708727,1449525,1259202,0
2091,2020-03-20,2020-03-24,5,3893130,511285,3381845,0
2092,2020-03-25,2020-03-26,2,1398114,208774,1189340,0
2093,2020-03-27,2020-03-29,3,2175861,557322,1618539,0
2094,2020-03-30,2020-04-01,3,1990548,590253,1400295,0
2095,2020-04-02,2020-04-04,3,2958474,1829223,1129251,0
2096,2020-04-05,2020-04-06,2,699602,647704,51898,0
2097,2020-04-07,2020-04-10,4,3390260,3043036,347224,0
2098,2020-04-11,2020-04-12,2,366606,316646,49960,0
2099,2020-04-13,2020-04-17,5,4026065,846600,3179465,0
2100,2020-04-18,2020-04-22,5,3931445,3749655,181790,0
2101,2020-04-23,2020-04-26,4,3956716,3858488,98228,0
2102,2020-04-27,2020-05-01,5,2514480,688980,1825500,0
2103,2020-05-02,2020-05-06,5,2444580,944900,1499680,0
2104,2020-05-07,2020-05-11,5,620710,613625,7085,0
2105,2020-05-12,2020-05-15,4,1113012,976776,136236,0
2106,2020-05-16,2020-05-18,3,1238754,1129833,108921,0
2107,2020-05-19,2020-05-23,5,3701965,893695,2808270,0
2108,2020-05-24,2020-05-28,5,2644945,843525,1801420,0
2109,2020-05-29,2020-06-02,5,4964570,1838360,3126210,0
2110,2020-06-03,2020-06-07,5,4769975,934970,3835005,0
2111,2020-06-08,2020-06-11,4,3651076,1820856,1830220,0
2112,2020-06-12,2020-06-16,5,582260,531660,50600,0
2113,2020-06-17,2020-06-21,5,2306425,2037570,268855,0
2114,2020-06-22,2020-06-23,2,1833504,655334,1178170,0
2115,2020-06-24,2020-06-28,5,4045840,1660555,2385285,0
2116,2020-06-29,2020-07-02,4,608628,587084,21544,0
2117,2020-07-03,2020-07-07,5,4807465,2090980,2716485,0
2118,2020-07-08,2020-07-12,5,2209060,1262005,947055,0
2119,2020-07-13,2020-07-17,5,3413575,1811055,1602520,0
2120,2020-07-18,2020-07-21,4,2206920,1261772,945148,0
2121,2020-07-22,2020-07-25,4,2886648,1047992,1838656,0
2122,2020-07-26,2020-07-27,2,239604,205324,34280,0
2123,2020-07-28,2020-08-01,5,1682675,1636950,45725,0
2124,2020-08-02,2020-08-03,2,1561592,753812,807780,0
2125,2020-08-04,2020-08-06,3,659745,455094,204651,0
2126,2020-08-07,2020-08-08,2,1982698,869926,1112772,0
2127,2020-08-09,2020-08-10,2,1847510,1052766,794744,0
2128,2020-08-11,2020-08-13,3,2264934,1218423,1046511,0
2129,2020-08-14,2020-08-17,4,1537524,726696,810828,0
2130,2020-08-18,2020-08-21,4,3788296,2775572,1012724,0
2131,2020-08-22,2020-08-25,4,1789988,782324,1007664,0
2132,2020-08-26,2020-08-29,4,3359608,3182584,177024,0
2133,2020-08-30,2020-09-01,3,2379549,1828629,550920,0
2134,2020-09-02,2020-09-05,4,510412,415640,94772,0
2135,2020-09-06,2020-09-09,4,3843556,3464500,379056,0
2136,2020-09-10,2020-09-12,3,2853582,1848297,1005285,0
2137,2020-09-13,2020-09-16,4,2297780,743496,1554284,0
2138,2020-09-17,2020-09-19,3,2770689,865044,1905645,0
2139,2020-09-20,2020-09-24,5,2335265,1451515,883750,0
2140,2020-09-25,2020-09-28,4,2217908,1758108,459800,0
2141,2020-09-29,2020-10-01,3,618876,469392,149484,0
2142,2020-10-02,2020-10-05,4,3102308,3084660,17648,0
2143,2020-10-06,2020-10-08,3,357348,346851,10497,0
2144,2020-10-09,2020-10-13,5,2326890,762480,1564410,0
2145,2020-10-14,2020-10-18,5,3084260,996140,2088120,0
2146,2020-10-19,2020-10-23,5,1371350,1342795,28555,0
2147,2020-10-24,2020-10-26,3,1860609,1769406,91203,0
2148,2020-10-27,2020-10-28,2,299040,207664,91376,0
2149,2020-10-29,2020-10-30,2,968494,253448,715046,0
2150,2020-10-31,2020-11-03,4,1841076,661140,1179936,0
2151,2020-11-04,2020-11-07,4,1693748,1109768,583980,0
2152,2020-11-08,2020-11-12,5,2112655,1031315,1081340,0
2153,2020-11-13,2020-11-14,2,1473206,925932,547274,0
2154,2020-11-15,2020-11-17,3,372591,312099,60492,0
2155,2020-11-18,2020-11-22,5,1159725,1024050,135675,0
2156,2020-11-23,2020-11-25,3,2250102,653265,1596837,0
2157,2020-11-26,2020-11-28,3,2856135,1833852,1022283,0
2158,2020-11-29,2020-12-03,5,1533400,1486790,46610,0
2159,2020-12-04,2020-12-08,5,1494260,833070,661190,0
2160,2020-12-09,2020-12-10,2,295306,239428,55878,0
2161,2020-12-11,2020-12-12,2,517394,379494,137900,0
2162,2020-12-13,2020-12-15,3,2095029,438372,1656657,0
2163,2020-12-16,2020-12-17,2,854566,413920,440646,0
2164,2020-12-18,2020-12-22,5,3905075,1549955,2355120,0
2165,2020-12-23,2020-12-24,2,1869374,822296,1047078,0
2166,2020-12-25,2020-12-28,4,2159240,1393116,766124,0
2167,2020-12-29,2020-12-30,2,1740724,856434,884290,0
2168,2020-12-31,2021-01-02,3,2297232,1590936,706296,0
2169,2021-01-03,2021-01-05,3,924408,567291,357117,0
2170,2021-01-06,2021-01-09,4,1686828,1620464,66364,0
2171,2021-01-10,2021-01-14,5,2656065,2201075,454990,0
2172,2021-01-15,2021-01-18,4,1869860,1442108,427752,0
2173,2021-01-19,2021-01-22,4,2628688,1821156,807532,0
2174,2021-01-23,2021-01-27,5,2423295,1000190,1423105,0
2175,2021-01-28,2021-02-01,5,2814820,666220,2148600,0
2176,2021-02-02,2021-02-03,2,1403608,533960,869648,0
2177,2021-02-04,2021-02-05,2,419836,289650,130186,0
2178,2021-02-06,2021-02-10,5,2096450,549010,1547440,0
2179,2021-02-11,2021-02-15,5,3843690,1940515,1903175,0
2180,2021-02-16,2021-02-20,5,4671925,3141065,1530860,0
2181,2021-02-21,2021-02-23,3,1033503,772923,260580,0
2182,2021-02-24,2021-02-28,5,1831130,888110,943020,0
2183,2021-03-01,2021-03-02,2,1003320,619532,383788,0
2184,2021-03-03,2021-03-06,4,723324,580092,143232,0
2185,2021-03-07,2021-03-09,3,567132,501612,65520,0
2186,2021-03-10,2021-03-11,2,1832184,1136732,695452,0
2187,2021-03-12,2021-03-16,5,2324280,1416425,907855,0
2188,2021-03-17,2021-03-18,2,1213544,535044,678500,0
2189,2021-03-19,2021-03-20,2,443346,356718,86628,0
2190,2021-03-21,2021-03-22,2,819024,762692,56332,0
2191,2021-03-23,2021-03-25,3,2734353,366636,2367717,0
2192,2021-03-26,2021-03-30,5,1639145,1337255,301890,0
2193,2021-03-31,2021-04-03,4,1882056,1465364,416692,0
2194,2021-04-04,2021-04-07,4,1348448,1185376,163072,0
2195,2021-04-08,2021-04-10,3,2233704,790329,1443375,0
2196,2021-04-11,2021-04-13,3,1828884,378756,1450128,0
2197,2021-04-14,2021-04-17,4,2054760,1865236,189524,0
2198,2021-04-18,2021-04-22,5,4197590,1839880,2357710,0
2199,2021-04-23,2021-04-26,4,869336,792924,76412,0
2200,2021-04-27,2021-04-30,4,1871180,490332,1380848,0
2201,2021-05-01,2021-05-02,2,758654,507338,251316,0
2202,2021-05-03,2021-05-06,4,2829408,504832,2324576,0
2203,2021-05-07,2021-05-10,4,3731496,3513212,218284,0
2204,2021-05-11,2021-05-15,5,1339765,538540,801225,0
2205,2021-05-16,2021-05-20,5,2727755,1879225,848530,0
2206,2021-05-21,2021-05-23,3,2943723,2683773,259950,0
2207,2021-05-24,2021-05-26,3,1332933,508332,824601,0
2208,2021-05-27,2021-05-30,4,3302920,2682436,620484,0
2209,2021-05-31,2021-06-01,2,280968,240372,40596,0
2210,2021-06-02,2021-06-04,3,1355430,795183,560247,0
2211,2021-06-05,2021-06-06,2,709546,605128,104418,0
2212,2021-06-07,2021-06-08,2,1413496,884072,529424,0
2213,2021-06-09,2021-06-10,2,1084510,283974,800536,0
2214,2021-06-11,2021-06-13,3,479049,439107,39942,0
2215,2021-06-14,2021-06-17,4,3669532,1612604,2056928,0
2216,2021-06-18,2021-06-21,4,2906532,799904,2106628,0
2217,2021-06-22,2021-06-25,4,3515944,2937316,578628,0
2218,2021-06-26,2021-06-27,2,1390974,624154,766820,0
2219,2021-06-28,2021-07-01,4,541064,412040,129024,0
2220,2021-07-02,2021-07-03,2,702020,629218,72802,0
2221,2021-07-04,2021-07-08,5,3644015,2269950,1374065,0
2222,2021-07-09,2021-07-13,5,1999220,856960,1142260,0
2223,2021-07-14,2021-07-17,4,3846192,2449648,1396544,0
2224,2021-07-18,2021-07-20,3,1186515,682332,504183,0
2225,2021-07-21,2021-07-22,2,239660,229632,10028,0
2226,2021-07-23,2021-07-24,2,1526764,1465788,60976,0
2227,2021-07-25,2021-07-28,4,1997412,488380,1509032,0
2228,2021-07-29,2021-07-30,2,651482,276606,374876,0
2229,2021-07-31,2021-08-04,5,2150970,950985,1199985,0
2230,2021-08-05,2021-08-08,4,506896,457212,49684,0
2231,2021-08-09,2021-08-13,5,4009035,932740,3076295,0
2232,2021-08-14,2021-08-16,3,2872038,2489937,382101,0
2233,2021-08-17,2021-08-20,4,3152076,1905964,1246112,0
2234,2021-08-21,2021-08-24,4,3521988,2001200,1520788,0
2235,2021-08-25,2021-08-27,3,2316102,2225352,90750,0
2236,2021-08-28,2021-08-31,4,3423768,2691452,732316,0
2237,2021-09-01,2021-09-05,5,3857150,2096510,1760640,0
2238,2021-09-06,2021-09-07,2,930646,870934,59712,0
2239,2021-09-08,2021-09-11,4,2652636,865332,1787304,0
2240,2021-09-12,2021-09-16,5,4185775,2969630,1216145,0
2241,2021-09-17,2021-09-21,5,2042755,1216530,826225,0
2242,2021-09-22,2021-09-23,2,743658,353666,389992,0
2243,2021-09-24,2021-09-25,2,556616,212242,344374,0
2244,2021-09-26,2021-09-29,4,1466444,1327152,139292,0
2245,2021-09-30,2021-10-01,2,355016,265128,89888,0
2246,2021-10-02,2021-10-04,3,2221920,1524780,697140,0
2247,2021-10-05,2021-10-09,5,3853030,816905,3036125,0
2248,2021-10-10,2021-10-14,5,1299665,609620,690045,0
2249,2021-10-15,2021-10-18,4,425708,419252,6456,0
2250,2021-10-19,2021-10-21,3,1087143,704094,383049,0
2251,2021-10-22,2021-10-23,2,286352,246920,39432,0
2252,2021-10-24,2021-10-27,4,3530996,2762008,768988,0
2253,2021-10-28,2021-10-30,3,2020296,913980,1106316,0
2254,2021-10-31,2021-11-04,5,1388380,1337035,51345,0
2255,2021-11-05,2021-11-09,5,2245725,564835,1680890,0
2256,2021-11-10,2021-11-11,2,701360,451966,249394,0
2257,2021-11-12,2021-11-14,3,319938,312969,6969,0
2258,2021-11-15,2021-11-16,2,354302,270210,84092,0
2259,2021-11-17,2021-11-21,5,2958190,2299610,658580,0
2260,2021-11-22,2021-11-24,3,2488065,1750341,737724,0
2261,2021-11-25,2021-11-27,3,2052594,1239141,813453,0
2262,2021-11-28,2021-12-02,5,1007155,542125,465030,0
2263,2021-12-03,2021-12-04,2,1647560,611764,1035796,0
2264,2021-12-05,2021-12-07,3,1303188,316530,986658,0
2265,2021-12-08,2021-12-09,2,1268420,647968,620452,0
2266,2021-12-10,2021-12-12,3,2823423,1202388,1621035,0
2267,2021-12-13,2021-12-14,2,1897388,1643620,253768,0
2268,2021-12-15,2021-12-19,5,2157150,1899840,257310,0
2269,2021-12-20,2021-12-24,5,2174040,846525,1327515,0
2270,2021-12-25,2021-12-27,3,2210715,892083,1318632,0
2271,2021-12-28,2021-12-31,4,1278028,475908,802120,0
2272,2022-01-01,2022-01-02,2,1472162,1381626,90536,0
2273,2022-01-03,2022-01-06,4,456468,417236,39232,0
2274,2022-01-07,2022-01-08,2,358696,274766,83930,0
2275,2022-01-09,2022-01-11,3,1618029,495846,1122183,0
2276,2022-01-12,2022-01-15,4,3255896,1970884,1285012,0
2277,2022-01-16,2022-01-19,4,601048,524716,76332,0
2278,2022-01-20,2022-01-24,5,1545485,1412315,133170,0
2279,2022-01-25,2022-01-29,5,4806645,3485135,1321510,0
2280,2022-01-30,2022-02-02,4,2322936,1341516,981420,0
2281,2022-02-03,2022-02-06,4,2285472,1452924,832548,0
2282,2022-02-07,2022-02-08,2,1633552,265360,1368192,0
2283,2022-02-09,2022-02-13,5,2442930,2202735,240195,0
2284,2022-02-14,2022-02-16,3,1205961,326097,879864,0
2285,2022-02-17,2022-02-21,5,4777805,610570,4167235,0
2286,2022-02-22,2022-02-24,3,2829027,353871,2475156,0
2287,2022-02-25,2022-02-26,2,548486,323546,224940,0
2288,2022-02-27,2022-02-28,2,386712,377164,9548,0
2289,2022-03-01,2022-03-03,3,1292889,725754,567135,0
2290,2022-03-04,2022-03-06,3,1135263,576465,558798,0
2291,2022-03-07,2022-03-10,4,485692,424324,61368,0
2292,2022-03-11,2022-03-12,2,640936,434140,206796,0
2293,2022-03-13,2022-03-15,3,1127106,857100,270006,0
2294,2022-03-16,2022-03-18,3,490914,301128,189786,0
2295,2022-03-19,2022-03-20,2,566504,317496,249008,0
2296,2022-03-21,2022-03-25,5,3494735,2166625,1328110,0
2297,2022-03-26,2022-03-29,4,3271608,877696,2393912,0
2298,2022-03-30,2022-03-31,2,1778572,1111360,667212,0
2299,2022-04-01,2022-04-03,3,1688562,1162299,526263,0
2300,2022-04-04,2022-04-05,2,1588838,625874,962964,0
